CDR3	Epitope	label
CASSLERDGYTF	VELGGGPGA	1
CASSLEASSYNSPLHF	VELGGGPGA	1
CASSLERETQYF	VELGGGPGA	1
CASSPTTGGDEAFF	QVELGGGPGAG	1
CASSLGPGQRETQYF	QVELGGGPG	1
CSARTEAYEQYF	AGSLQPLALE	1
CSARDQQRVDTQYF	AGSLQPLAL	1
CASARRTSGEDTQYF	AALALLLLDRLNQLE	1
CASSPRTLTVPRGTDTQYF	AALALLLLDRLNQLE	1
CASSPRDRANTGELFF	NCTFEYVSQPFLMDL	1
CASSVRDRPNTGELFF	NCTFEYVSQPFLMDL	1
CASSVRDRVNTGELFF	NCTFEYVSQPFLMDL	1
CASSPRGDGYTF	NCTFEYVSQPFLMDL	1
CASSPGAETQYF	RISNCVADYSVLYNS	1
CAWSEGQGVGQPQHF	VGGNYNYLYRLFRKS	1
CAWRRMNTEAFF	VGGNYNYLYRLFRKS	1
CAWSGPAGSMSGELFF	VGGNYNYLYRLFRKS	1
CASSVDSSSGNTIYF	VGGNYNYLYRLFRKS	1
CASSPGNVASGRYQETQYF	NNSYECDIPIGAGIC	1
CASSVDPNTEAFF	NNSYECDIPIGAGIC	1
CATSSYRGKNEKLFF	HWFVTQRNFYEPQII	1
CASSSGEGGETQYF	HWFVTQRNFYEPQII	1
CASRPLQGSHGYTF	HWFVTQRNFYEPQII	1
CASSRAGGASTDTQYF	HWFVTQRNFYEPQII	1
CSARRGTEAFF	NLLLQYGSFCTQLNRAL	1
CATSAPDRGNNQPQHF	NLLLQYGSFCTQLNRAL	1
CATSDFRVGDNQPQHF	NLLLQYGSFCTQLNRAL	1
CATSDPDRGDNQPQHF	NLLLQYGSFCTQLNRAL	1
CATSDPGQGDHQPQHF	NLLLQYGSFCTQLNRAL	1
CATSDPGQGNNQPQHF	NLLLQYGSFCTQLNRAL	1
CATSDPRQGDNQPQHF	NLLLQYGSFCTQLNRAL	1
CATSDPRTGDNQPQHF	NLLLQYGSFCTQLNRAL	1
CATSDPRVGDNQPQHF	NLLLQYGSFCTQLNRAL	1
CATSDPSRGDNQPQHF	NLLLQYGSFCTQLNRAL	1
CATSDVSGGNYNEQFF	NLLLQYGSFCTQLNRAL	1
CASSEGASNQPQHF	NLLLQYGSFCTQLNRAL	1
CASSEGVSNQPQHF	NLLLQYGSFCTQLNRAL	1
CASRPVAGLPHF	PQPELPYPQPE	1
CASSIVDRGGETQYF	PQPELPYPQPE	1
CASSLGYGVSTGELFF	PQPELPYPQPE	1
CASSLRAWETQYF	PQPELPYPQPE	1
CASSLRWGDGGKLFF	PQPELPYPQPE	1
CASSQGGDRGESEAFF	PQPELPYPQPE	1
CASSVRTLDTGELFF	PQPELPYPQPE	1
CATSSRMGGDTQYF	PQPELPYPQPE	1
CASSINALVGEQFF	QLQPFPQPELPY	1
CASSPAFSTDTQYF	QLQPFPQPELPY	1
CASSLDGLTNTEAFF	QLQPFPQPELPY	1
CSATLGGDYGYTF	PQQPFPQPEQPFP	1
CSAQLAGGGGDTQYF	PQQPFPQPEQPFP	1
CSAFPGGDTEAFF	PQQPFPQPEQPFP	1
CASSYVGGDTDTQYF	PQQPFPQPEQPFP	1
CASSIRTDTQYF	PQPQLPYPQPQ	1
CASSFRHTDTQYF	PQPQLPYPQPQ	1
CASSLRTSGSHEQYF	PQPQLPYPQPQ	1
CASSLRAAGDHEQYF	PQPQLPYPQPQ	1
CASSKRTGDVGEQF	PQPQLPYPQPQ	1
CASSIRAGADEQF	PQPQLPYPQPQ	1
CASSLSPRADTQYF	PQPQLPYPQPQ	1
CASSPRSSGTEQYF	PQPQLPYPQPQ	1
CASSPPGLPYEQYF	PQPQLPYPQPQ	1
CASSLGWQNNEQF	PQPQLPYPQPQ	1
CASSLAGFPDEQF	PQPQLPYPQPQ	1
CASSLRAAGGHEQYF	PQPQLPYPQPQ	1
CASSIRHTDTQYF	PQPQLPYPQPQ	1
CASLIRFTDTQYF	PQPQLPYPQPQ	1
CASSIRTEDTQYF	PQPQLPYPQPQ	1
CASSLVGWETQYF	PQPQLPYPQPQ	1
CASSTRTGDGGTQYF	PQPQLPYPQPQ	1
CASSIRFTDTQYF	PQPELPYPQPE	1
CASSVRHTDTQYF	PQPELPYPQPE	1
CASSIRTGGDTQYF	PQPELPYPQPE	1
CASSLGGSTDTQYF	PQPELPYPQPE	1
CASSVRTGDSQPQHF	PQPELPYPQPE	1
CASSLRGLDMGTQYF	PQPELPYPQPE	1
CASSLRWGDEGEQYF	PQPELPYPQPE	1
CASSLRAGGNHEQYF	PQPELPYPQPE	1
CASSLRASGSHEQYF	PQPELPYPQPE	1
CASSLATRATYEQYF	PQPELPYPQPE	1
CASLLGRSNTGELFF	PQPELPYPQPE	1
CASSLRSGGADTQYF	PQPELPYPQPE	1
CASSSDRNYGYTF	PQPELPYPQPE	1
CASSFPGALNYGYTF	PQPELPYPQPE	1
CASSFSGTSPYEQF	PQPELPYPQPE	1
CASSFGGGTYEQYF	PQPELPYPQPE	1
CASSLVERGPYEQYF	PQPELPYPQPE	1
CASSLVSGGMDEQF	PQPELPYPQPE	1
CASSLQASSYNEQF	PQPELPYPQPE	1
CASSPRGRNYEQYF	PQPELPYPQPE	1
CASSPEGVRVGYGYTF	PQPELPYPQPE	1
CASSLAGGLHTDTQYF	PQPELPYPQPE	1
CASSLAGPLRFNEQF	PQPELPYPQPE	1
CASSLMGLSNYGYTF	PQPELPYPQPE	1
CASSLSAGPGANVLTF	PQPELPYPQPE	1
CASSLEGAFSANYGYTF	PQPELPYPQPE	1
CASSLRGTYGSGANVLTF	PQPELPYPQPE	1
CASSPQLGVPFF	PQPELPYPQPQ	1
CASSLNQGGGYTF	PQPELPYPQPQ	1
CASSFRLDRYGYTF	PQPELPYPQPQ	1
CASSQGQSSYNEQF	PQPELPYPQPQ	1
CASSVQGRVNTEAF	PQPELPYPQPQ	1
CASSAGTLPTGELF	PQPELPYPQPQ	1
CASSLARRFYNSPLHF	PQPELPYPQPQ	1
CASSLEGRGYTF	PQPELPYPQPQ	1
CASSLVGEKAFF	PQPELPYPQPQ	1
CASSLSRYEQF	PQPELPYPQPQ	1
CASSLAGVQPQHF	PQPELPYPQPQ	1
CASSSPVGGEQF	PQPELPYPQPQ	1
CASSSGGGYNEQF	PQPELPYPQPQ	1
CASSSLGGAETQYF	PQPELPYPQPQ	1
CASSSSQGNQPQHF	PQPELPYPQPQ	1
CASSKSRGSYEQYF	PQPELPYPQPQ	1
CASSPDGVNSPLHF	PQPELPYPQPQ	1
CASSPNRSGNTIYF	PQPELPYPQPQ	1
CASSTRQSAYEQYF	PQPELPYPQPQ	1
CASSLDAGNEKLF	PQPELPYPQPQ	1
CASSLARGVGNIQYF	PQPELPYPQPQ	1
CASSLEGQGISPLHF	PQPELPYPQPQ	1
CASSLELSGANVLTF	PQPELPYPQPQ	1
CASSLGIGPYNEQF	PQPELPYPQPQ	1
CASSVSFGQGYEQYF	PQPELPYPQPQ	1
CASSRGGTSGLHTQYF	PQPELPYPQPQ	1
CASSFQGGDGETQYF	PQPELPYPQPQ	1
CASSLGQPSTDTQYF	PQPELPYPQPQ	1
CASSIRTSGAHEQYF	PQPELPYPQPQ	1
CASSLRAGGSHEQYF	PQPELPYPQPQ	1
CASSFQRGAADTQYF	PQPELPYPQPQ	1
CASSFRVGAVDTQYF	PQPELPYPQPQ	1
CASSIRWTDTQYF	PQPELPYPQPQ	1
CASSQVYGGDTQYF	PQPELPYPQPQ	1
CASSWTGGHTDTQYF	PQPELPYPQPQ	1
CASSEQREGEQYF	PQPELPYPQPQ	1
CASSIRAGGTDTQYF	PQPELPYPQPQ	1
CASSIRDTDTQYF	PQPELPYPQPQ	1
CASSIRTGDHEQYF	PQPELPYPQPQ	1
CASSIRTGGETQYF	PQPELPYPQPQ	1
CASSIRTTDTQYF	PQPELPYPQPQ	1
CASSIRYTDTQYF	PQPELPYPQPQ	1
CASSLASYGDTQYF	PQPELPYPQPQ	1
CASSLVAYSGETQYF	PQPELPYPQPQ	1
CASSTRTTDTQYF	PQPELPYPQPQ	1
CASSTRWSDTQYF	PQPELPYPQPQ	1
CASSVRFTDTQYF	PQPELPYPQPQ	1
CASSIRQGGNHEQYF	PQPELPYPQPQ	1
CASSQDGQGPETQYF	PQPELPYPQPQ	1
CASSFRVSDTQYF	PQPELPYPQPQ	1
CASSIRNTDTQYF	PQPELPYPQPQ	1
CASSLRAGGVDTQYF	PQPELPYPQPQ	1
CASSQPHRGDEQFF	PQPELPYPQPQ	1
CASSARFTDTQYF	PQPELPYPQPQ	1
CASSFRTSDTQYF	PQPELPYPQPQ	1
CASSLRSGDTQYF	PQPELPYPQPQ	1
CASSLVAWETQYF	PQPELPYPQPQ	1
CASSVRGGEADTQYF	PQPELPYPQPQ	1
CSVSGGPSTDTQYF	PFPQPELPY	1
CSVGQTDSPLHF	PFPQPELPY	1
CSAGQGGTGELFF	PFPQPELPY	1
CSVAALAGFQETQYF	PFPQPELPY	1
CSASRWRSTDTQYF	PFPQPELPY	1
CSAGVGGQETQYF	PFPQPELPY	1
CSAYRTWDQETQYF	PFPQPELPY	1
CSAREPDNTGELFF	PFPQPELPY	1
CSARGYGLANPYEQYF	PFPQPELPY	1
CASSLASAGGTDTQYF	PFPQPELPY	1
CASSLNWDTEAFF	PFPQPELPY	1
CASSFSPAGSEAFF	PFPQPELPY	1
CASSLEGQGASEQFF	PFPQPELPY	1
CASSQGLAGVQETQYF	PFPQPELPY	1
CASSPTALGTDTQYF	PFPQPELPY	1
CASSFRFTDTQYF	PQPELPYPQ	1
CASSFRALAADTQYF	PQPELPYPQ	1
CASSIRTSGDHEQYF	PQPELPYPQ	1
CASSQYQSLVRGNNEQFF	PQPELPYPQ	1
CASSFPQVTDTQYF	PQPELPYPQ	1
CASSHVDRGGETQYF	PQPELPYPQ	1
CASSLVLAGGRKQFF	DPFRLLQNSQVFS	1
CASSSRTTSNQPQHF	DPFRLLQNSQVFS	1
CASSLRFGGSHEQYF	DPFRLLQNSQVFS	1
CASSLAMGGGTEAFF	DPFRLLQNSQVFS	1
CSAASDGPDTQYF	DPFRLLQNSQVFS	1
CASSLVLAGGREQFF	DPFRLLQNSQVFS	1
CASTSRPFSGHEQYF	DPFRLLQNSQVFS	1
CASRIKFANTGELFF	DPFRLLQNSQVFS	1
CASSLGLGATQYF	DPFRLLQNSQVFS	1
CASSQERGVRSSQYGSNQPQHF	DPFRLLQNSQVFS	1
CSAGRTSGGDTQYF	DPFRLLQNSQVFS	1
CASSLNRGSNQPQHF	DPFRLLQNSQVFS	1
CASTLNLAGAKNIQYF	DPFRLLQNSQVFS	1
CASSLVGETQYF	DPFRLLQNSQVFS	1
CSAREGTARYEQYF	DPFRLLQNSQVFS	1
CASSLVLAGGREQFF	DPFRLLQNSQVFS	1
CASSLEGSPSQNTEAFF	DPFRLLQNSQVFS	1
CASSTGQVRLQPQHF	DPFRLLQNSQVFS	1
CASTPLRGTEAFF	DPFRLLQNSQVFS	1
CASSTGGGETYEQYF	DPFRLLQNSQVFS	1
CASSPGGSSYEQYF	DPFRLLQNSQVFS	1
CASRVADTQYF	DPFRLLQNSQVFS	1
CASSLDTGRNSPLHF	DPFRLLQNSQVFS	1
CASSEIRVAQPQHF	DPFRLLQNSQVFS	1
CAISRDGLTSTDTQYF	DPFRLLQNSQVFS	1
CSAREGQGTYEQYF	DPFRLLQNSQVFS	1
CASSLGRSDTQYF	DPFRLLQNSQVFS	1
CASSSTGTSGGQTQYF	DPFRLLQNSQVFS	1
CASRVAGVTGELFF	DPFRLLQNSQVFS	1
CSARTPDAPEAFF	DPFRLLQNSQVFS	1
CSARKTGEETQYF	DPFRLLQNSQVFS	1
CASSDGTGGGQPQHF	DPFRLLQNSQVFS	1
CASSPIGGADEKLFF	DPFRLLQNSQVFS	1
CATSRDKGTEKLFF	DPFRLLQNSQVFS	1
CASSLRQGNQPQHF	DPFRLLQNSQVFS	1
CASSSYRDGGYTF	DPFRLLQNSQVFS	1
CASSLNIWDGDGNTIYF	DPFRLLQNSQVFS	1
CASRTAWGRTWSEAFF	DPFRLLQNSQVFS	1
CASSLVGNRRSNTQYF	DPFRLLQNSQVFS	1
CASRMDRVGGSPLHF	DPFRLLQNSQVFS	1
CASSARPGNTIYF	DPFRLLQNSQVFS	1
CASSQDFGQLHF	DPFRLLQNSQVFS	1
CAPPGDGYTF	DPFRLLQNSQVFS	1
CASSLGSGVSNYGYTF	GLIYNRMGAVTTEV	1
CASSLDWGGYTF	GLIYNRMGAVTTEV	1
CASCQGRGGTDTQYF	GLIYNRMGAVTTEV	1
CASTPSQGTTYEQYF	GLIYNRMGAVTTEV	1
CAISESIVTEAFF	GLIYNRMGAVTTEV	1
CSARVGQLGYNEQFF	GLIYNRMGAVTTEV	1
CASSPNAGYYGYTF	GLIYNRMGAVTTEV	1
CASSFQEGASSPLHF	GLIYNRMGAVTTEV	1
CASTSRGVVDEQYF	GLIYNRMGAVTTEV	1
CASSSLLGGGANVLTF	GLIYNRMGAVTTEV	1
CASSLGRELFF	GLIYNRMGAVTTEV	1
CACHADGRETQYF	GLIYNRMGAVTTEV	1
CASSLPGGANVLTF	GLIYNRMGAVTTEV	1
CASSSNRGTGANVLTF	GLIYNRMGAVTTEV	1
CASSFIAGQGRETQYF	GLIYNRMGAVTTEV	1
CAWSPQGYGGEAFF	GLIYNRMGAVTTEV	1
CSAARQAGTEAFF	GLIYNRMGAVTTEV	1
CASRTTGGNTEAFF	GLIYNRMGAVTTEV	1
CASSREGPPDTEAFF	PKYVKQNTLKLAT	1
CASSYSGGVGETQYF	PKYVKQNTLKLAT	1
CASTPGTGDVQPQHF	PKYVKQNTLKLAT	1
CASSLGDSNGYTF	PKYVKQNTLKLAT	1
CASIPGLEVLSNEQFF	PKYVKQNTLKLAT	1
CASSPPGAGEGETQYF	PKYVKQNTLKLAT	1
CASSTGSDFDNYGYTF	PKYVKQNTLKLAT	1
CASSDAGLGDYEQYF	PKYVKQNTLKLAT	1
CATSDESYGYTF	PKYVKQNTLKLAT	1
CASSQVGPIQETQYF	PKYVKQNTLKLAT	1
CASSPYRGPMNTEAFF	PKYVKQNTLKLAT	1
CASRTINTEAFF	PKYVKQNTLKLAT	1
CASSLGLGATQYF	PKYVKQNTLKLAT	1
CAWSRRGEQYF	PKYVKQNTLKLAT	1
CASTSRPFSGHEQYF	PKYVKQNTLKLAT	1
CASSTLGQGPDTQYF	PKYVKQNTLKLAT	1
CSAQNTGYNEQFF	PKYVKQNTLKLAT	1
CSADRGRDTEAFF	PKYVKQNTLKLAT	1
CASSLGAGDYNEQFF	QARQMVQAMRTIGTHP	1
CASSSRDSYSTQYF	QARQMVQAMRTIGTHP	1
CASSLIGYEQYF	QARQMVQAMRTIGTHP	1
CASSLGTLGNTIYF	QARQMVQAMRTIGTHP	1
CSARDYVMDTQYF	QARQMVQAMRTIGTHP	1
CASSIGTVGFRAFF	QARQMVQAMRTIGTHP	1
CSARDLQGAYNSPLHF	QARQMVQAMRTIGTHP	1
CSARDLAPSSYNSPLHF	QARQMVQAMRTIGTHP	1
CSARDLQGSYNSPLHF	QARQMVQAMRTIGTHP	1
CASSKGLAEFTDTQYF	QARQMVQAMRTIGTHP	1
CASSDKVLETQYF	QARQMVQAMRTIGTHP	1
CASSASWDAVGKAFF	QARQMVQAMRTIGTHP	1
CASSSSFLGNQPQHF	QARQMVQAMRTIGTHP	1
CSARDSYEQYF	QARQMVQAMRTIGTHP	1
CASSLGGLNNEQFF	QARQMVQAMRTIGTHP	1
CASSYSFLVSGSTEAFF	QARQMVQAMRTIGTHP	1
CASKQGYDSFTGELFF	QARQMVQAMRTIGTHP	1
CASSYSFLGKDNSPLHF	QARQMVQAMRTIGTHP	1
CASSSSFLGNQPQHF	QARQMVQAMRTIGTHP	1
CASNNRGSTDTQYF	QARQMVQAMRTIGTHP	1
CASRPRYGGAPGELFF	QARQMVQAMRTIGTHP	1
CSARDLSPLGQGSSYNSPLHF	QARQMVQAMRTIGTHP	1
CASSYSLTATGAGELFF	QARQMVQAMRTIGTHP	1
CSARDGVRQYF	QARQMVQAMRTIGTHP	1
CASSQERGVRSSQYGSNQPQHF	QARQMVQAMRTIGTHP	1
CASSFGQNSEQYF	QARQMVQAMRTIGTHP	1
CASSYSFTGTGTEAFF	QARQMVQAMRTIGTHP	1
CASSLRSGQGLDFF	QARQMVQAMRTIGTHP	1
CASSLEGARGPNQPQHF	SGPLKAEIAQRLED	1
CASTSPDRGNEKLFF	SGPLKAEIAQRLED	1
CASSQASSGGKETQYF	SGPLKAEIAQRLED	1
CASSGAGDRGPNQPQHF	SGPLKAEIAQRLED	1
CASSPWDRLNTEAFF	SGPLKAEIAQRLED	1
CASSRTVNQPQHF	SGPLKAEIAQRLED	1
CASSQPSRGNQETQYF	SGPLKAEIAQRLED	1
CSAASDGPDTQYF	SGPLKAEIAQRLED	1
CASSSNRGTGANVLTF	SGPLKAEIAQRLED	1
CASSEGNRGLYEQYF	SGPLKAEIAQRLED	1
CSADRGRDTEAFF	SGPLKAEIAQRLED	1
CATSGHNRGSYEQYF	SGPLKAEIAQRLED	1
CASSQPGSYEQYF	SGPLKAEIAQRLED	1
CASSAEIDGWGLVNEQFF	SGPLKAEIAQRLED	1
CASSSPSGGAPYNEQFF	SGPLKAEIAQRLED	1
CASSQGGPKSGANVLTF	SGPLKAEIAQRLED	1
CASRIGSGANVLTF	SGPLKAEIAQRLED	1
CASSRAGAGSTEAFF	SGPLKAEIAQRLED	1
CASSLGQVDNVLTF	SGPLKAEIAQRLED	1
CASSNTDNQPQHF	SGPLKAEIAQRLED	1
CASSYSRGLAGDTQYF	DPFRLLQNSQVFS	1
CASSLIIAGVRELFF	DPFRLLQNSQVFS	1
CASSSRTGGTDTQYF	DPFRLLQNSQVFS	1
CASSLRIAGGPDTQYF	DPFRLLQNSQVFS	1
CASNPTTRSGELFF	DPFRLLQNSQVFS	1
CASSDAGTGVDRRSSGANVLTF	DPFRLLQNSQVFS	1
CASSFVFSGANVLTF	DPFRLLQNSQVFS	1
CASSLVVAGYQETQYF	DPFRLLQNSQVFS	1
CASSLSRGHETQYF	DPFRLLQNSQVFS	1
CASSPVFSGANVLTF	DPFRLLQNSQVFS	1
CASSAAWGREGPDGTEAFF	DPFRLLQNSQVFS	1
CSAETGGSTEAFF	DPFRLLQNSQVFS	1
CASRISGTGSHEQFF	DPFRLLQNSQVFS	1
CSVGPGRPGYTF	DPFRLLQNSQVFS	1
CASSQDLRGYTEAFF	DPFRLLQNSQVFS	1
CASSSPVRGHEQYF	DPFRLLQNSQVFS	1
CASSPRLGGSYEQYF	DPFRLLQNSQVFS	1
CASSLNRLNTEAFF	DPFRLLQNSQVFS	1
CASTTRRRSNEKLFF	DPFRLLQNSQVFS	1
CASSTRLAGYNEQFF	DPFRLLQNSQVFS	1
CASSVNRGSNQPQHF	DPFRLLQNSQVFS	1
CASSLGANGHRNTEAFF	DPFRLLQNSQVFS	1
CASSPRTTSEAFF	DPFRLLQNSQVFS	1
CASSTITGLAGGELFF	DPFRLLQNSQVFS	1
CASSSGSGKNTEAFF	GLIYNRMGAVTTEV	1
CASSLDAGSVREQFF	GLIYNRMGAVTTEV	1
CASSWDWSGYTF	GLIYNRMGAVTTEV	1
CASSLSGTGSQETQYF	GLIYNRMGAVTTEV	1
CASSLDWGREAFF	GLIYNRMGAVTTEV	1
CASTTVGNNSPLHF	GLIYNRMGAVTTEV	1
CASRQESTEAFF	GLIYNRMGAVTTEV	1
CASSALTGLGGYTF	GLIYNRMGAVTTEV	1
CASSLFTSGGYEQYF	GLIYNRMGAVTTEV	1
CASSLDLGQGSNEQFF	GLIYNRMGAVTTEV	1
CASSFTGRNEQFF	GLIYNRMGAVTTEV	1
CASSEGRNYNQPQHF	GLIYNRMGAVTTEV	1
CASSQLAGGTSTDTQYF	GLIYNRMGAVTTEV	1
CSASQGQGQLAQHF	GLIYNRMGAVTTEV	1
CASSQDYYGYTF	GLIYNRMGAVTTEV	1
CASSLQDNSYNEQFF	GLIYNRMGAVTTEV	1
CASSQDGTSGFEQFF	GLIYNRMGAVTTEV	1
CASHREGNGYTF	GLIYNRMGAVTTEV	1
CASSYGMGGALGDEQFF	GLIYNRMGAVTTEV	1
CASSIFGEQFF	GLIYNRMGAVTTEV	1
CASSYHILAGGQGDTQYF	GLIYNRMGAVTTEV	1
CASSLVDREELFF	GLIYNRMGAVTTEV	1
CASRRTAGNSPLHF	GLIYNRMGAVTTEV	1
CASNHAVKAFF	GLIYNRMGAVTTEV	1
CASSLLGSGSDNEQFF	GLIYNRMGAVTTEV	1
CASSLYTEAFF	GLIYNRMGAVTTEV	1
CASSMTAGTEAFF	GLIYNRMGAVTTEV	1
CASSLRPTNEQFF	GMFNMLSTVLGVS	1
CSARRGGDTQYF	GMFNMLSTVLGVS	1
CAWKSRLAGNTGELFF	GMFNMLSTVLGVS	1
CASISWDRGQYYGYTF	GMFNMLSTVLGVS	1
CASSPLARRGGYNEQFF	GMFNMLSTVLGVS	1
CSARRGGDTQYF	GMFNMLSTVLGVS	1
CASSYPTGQGNYGYTF	PKYVKQNTLKLAT	1
CASSLSQGSRTF	PKYVKQNTLKLAT	1
CASSPLQGTGSGANVLTF	PKYVKQNTLKLAT	1
CATSSPTGELFF	PKYVKQNTLKLAT	1
CAWSLGRGNEQFF	PKYVKQNTLKLAT	1
CASSFGPGGEAGELFF	PKYVKQNTLKLAT	1
CASSVDVAGPETQYF	PKYVKQNTLKLAT	1
CATSRGWDRADTEAFF	PKYVKQNTLKLAT	1
CASSYDSNYGYTF	PKYVKQNTLKLAT	1
CASANPGGRTGELFF	PKYVKQNTLKLAT	1
CASSESEDPSVGEQFF	PKYVKQNTLKLAT	1
CASSLRTGLINTEAFF	PKYVKQNTLKLAT	1
CASSLAQGEQFF	PKYVKQNTLKLAT	1
CATSDPMGKLFF	PKYVKQNTLKLAT	1
CASSPGRSVDTIYF	PKYVKQNTLKLAT	1
CASRQESTEAFF	PKYVKQNTLKLAT	1
CAWTPSGASTDTQYF	PKYVKQNTLKLAT	1
CASSSAGGFYEQYF	PKYVKQNTLKLAT	1
CASSVGPGTANTGELFF	PKYVKQNTLKLAT	1
CASSILGTAYTDTQYF	PKYVKQNTLKLAT	1
CASSLSHEQFF	PKYVKQNTLKLAT	1
CASTDSGSGAYEQYF	PKYVKQNTLKLAT	1
CATSDSEDRVGAEAFF	PKYVKQNTLKLAT	1
CASSLLQGEPMGYTF	PKYVKQNTLKLAT	1
CAWSAAVLGFNEQFF	PKYVKQNTLKLAT	1
CASSYGGSTDTQYF	PKYVKQNTLKLAT	1
CAWNPGANQPQHF	PKYVKQNTLKLAT	1
CASSLRGTGVYSNQPQHF	PKYVKQNTLKLAT	1
CASSIGQGEQFF	PKYVKQNTLKLAT	1
CASSVGPGTANTGELFF	PKYVKQNTLKLAT	1
CASSPGPEGGYTF	PKYVKQNTLKLAT	1
CASSLGQASNQPQHF	QARQMVQAMRTIGTHP	1
CASSFGSYGEQYF	QARQMVQAMRTIGTHP	1
CSARNLGASFDEQFF	QARQMVQAMRTIGTHP	1
CSARGLQGDYNSPLHF	QARQMVQAMRTIGTHP	1
CASSQDTYTEAFF	QARQMVQAMRTIGTHP	1
CSARDLGGNYNSPLHF	QARQMVQAMRTIGTHP	1
CASSLAGGTFSTDTQYF	QARQMVQAMRTIGTHP	1
CASSARDSYNYGYTF	QARQMVQAMRTIGTHP	1
CSAQDRDSGNTIYF	QARQMVQAMRTIGTHP	1
CSARDLQGSYNSPLHF	QARQMVQAMRTIGTHP	1
CASSPLGYTDTQYF	QARQMVQAMRTIGTHP	1
CASSTGLAGVYQETQYF	QARQMVQAMRTIGTHP	1
CASSLGFFETQYF	QARQMVQAMRTIGTHP	1
CSARDLQGAYNSPLHF	QARQMVQAMRTIGTHP	1
CASSPGGLNNEQFF	QARQMVQAMRTIGTHP	1
CASSSPRGDLTDTQYF	QARQMVQAMRTIGTHP	1
CASSLVDREELFF	QARQMVQAMRTIGTHP	1
CASSLERAEQYF	QARQMVQAMRTIGTHP	1
CSARPLRESYNSPLHF	QARQMVQAMRTIGTHP	1
CASSSGLAGMLADTQYF	QARQMVQAMRTIGTHP	1
CSARDLGGTYNSPLHF	QARQMVQAMRTIGTHP	1
CAWSAGTAHQPQHF	QARQMVQAMRTIGTHP	1
CASRQESTEAFF	QARQMVQAMRTIGTHP	1
CASSLSGAGQPQHF	QARQMVQAMRTIGTHP	1
CASSSGQRNTGELFF	QARQMVQAMRTIGTHP	1
CASTWGNQPQHF	QARQMVQAMRTIGTHP	1
CASSLGAFNEQFF	QARQMVQAMRTIGTHP	1
CSARIYTGGRYNSPLHF	QARQMVQAMRTIGTHP	1
CASSFGDQETQYF	QARQMVQAMRTIGTHP	1
CASSVGTENQPQHF	QARQMVQAMRTIGTHP	1
CASSLYTEAFF	QARQMVQAMRTIGTHP	1
CASSPRAGYTF	QARQMVQAMRTIGTHP	1
CASSSPGTGYSEAFF	QARQMVQAMRTIGTHP	1
CASSLMDTYNEQFF	QARQMVQAMRTIGTHP	1
CSAPDRGANSPLHF	QARQMVQAMRTIGTHP	1
CASSVGDLAGTDTQYF	QARQMVQAMRTIGTHP	1
CASSTTGSTEAFF	QARQMVQAMRTIGTHP	1
CASSLWEGASGNTIYF	QARQMVQAMRTIGTHP	1
CSARDLDPSSYNSPLHF	QARQMVQAMRTIGTHP	1
CASSNHPFAEAFF	QARQMVQAMRTIGTHP	1
CASSLSTGIQPQHF	SGPLKAEIAQRLED	1
CASSSTGYGYTF	SGPLKAEIAQRLED	1
CASSLDRRGSATNEQFF	SGPLKAEIAQRLED	1
CSVDRQDRGFYGYTF	SGPLKAEIAQRLED	1
CATSDPQGGSTEAFF	SGPLKAEIAQRLED	1
CASSQILLDSPLHF	SGPLKAEIAQRLED	1
CATQGSPDRGPNQPQHF	SGPLKAEIAQRLED	1
CASSPRTSGGPYNEQFF	SGPLKAEIAQRLED	1
CATSDLDEQYF	SGPLKAEIAQRLED	1
CAWSVPDRGRFGYTF	SGPLKAEIAQRLED	1
CASRPRYGGAPGELFF	DPFRLLQNSQVFS	1
CASSLVLAGVKTQYF	DPFRLLQNSQVFS	1
CASCQGRGGTDTQYF	DPFRLLQNSQVFS	1
CASSPLQGRNQPQHF	DPFRLLQNSQVFS	1
CSVEAGGLTEAFF	DPFRLLQNSQVFS	1
CSASGDGGTSTDTQYF	DPFRLLQNSQVFS	1
CASSSPSGGAPYNEQFF	DPFRLLQNSQVFS	1
CASSLVFGGAQTQYF	DPFRLLQNSQVFS	1
CASSFQGASTEAFF	DPFRLLQNSQVFS	1
CASSLSGLTGNQPQHF	DPFRLLQNSQVFS	1
CASSTLKSTDTQYF	DPFRLLQNSQVFS	1
CASSLEGSPSQNTEAFF	DPFRLLQNSQVFS	1
CATSALNEQFF	DPFRLLQNSQVFS	1
CASSGQGAGYGYTF	GLIYNRMGAVTTEV	1
CASSLLGGSTNTGELFF	GLIYNRMGAVTTEV	1
CASSPDWGGEQFF	GLIYNRMGAVTTEV	1
CSATTGNPGQPQHF	GLIYNRMGAVTTEV	1
CASRREYSTDTQYF	GLIYNRMGAVTTEV	1
CASSPDYGGTTF	GLIYNRMGAVTTEV	1
CASSSGYTEAFF	GLIYNRMGAVTTEV	1
CASSQQGGVMNEKLFF	GLIYNRMGAVTTEV	1
CASSQGPSEGFSPLHF	GLIYNRMGAVTTEV	1
CAGSTNTGELFF	GLIYNRMGAVTTEV	1
CASSLNQLAGGGGTQYF	GLIYNRMGAVTTEV	1
CASSQEGTGGGNTEAFF	GLIYNRMGAVTTEV	1
CASSLLGDTSTDTQYF	GLIYNRMGAVTTEV	1
CASGDRGAIETQYF	GLIYNRMGAVTTEV	1
CASSRLGAGMIQETQYF	GLIYNRMGAVTTEV	1
CASSSTGNTEAFF	GLIYNRMGAVTTEV	1
CASSGSGAFYEQYF	GLIYNRMGAVTTEV	1
CSVARDPNSYEQYF	GLIYNRMGAVTTEV	1
CASKLTGGGLDEQFF	GLIYNRMGAVTTEV	1
CASSRTSGGSVQETQYF	GLIYNRMGAVTTEV	1
CAIKTEMADTQYF	GLIYNRMGAVTTEV	1
CASSPSGPGLTGNTIYF	GLIYNRMGAVTTEV	1
CASSQLATGYGYTF	GLIYNRMGAVTTEV	1
CASQKRGDTDTQYF	GLIYNRMGAVTTEV	1
CASSLDLRRTTEAFF	GLIYNRMGAVTTEV	1
CASSYSGRNTEAFF	GLIYNRMGAVTTEV	1
CSVAGTSGDTQYF	GLIYNRMGAVTTEV	1
CASSLEQNNYGYTF	GLIYNRMGAVTTEV	1
CASKRTDISGANVLTF	GLIYNRMGAVTTEV	1
CASSSTSGGAWGTDTQYF	GLIYNRMGAVTTEV	1
CASSLQRMNTEAFF	GLIYNRMGAVTTEV	1
CASKIRFMNTEAFF	GLIYNRMGAVTTEV	1
CASTYSSPNYGYTF	GLIYNRMGAVTTEV	1
CASSLGGVRGNTEAFF	GLIYNRMGAVTTEV	1
CASSLEGSPSQNTEAFF	GMFNMLSTVLGVS	1
CSARVGGDTQYF	GMFNMLSTVLGVS	1
CASSARPGNTIYF	GMFNMLSTVLGVS	1
CARKTGHNEKLFF	GMFNMLSTVLGVS	1
CASSVRQDNEQFF	GMFNMLSTVLGVS	1
CSARVGGDTQYF	GMFNMLSTVLGVS	1
CSARVGGDTQYF	GMFNMLSTVLGVS	1
CASSSDQQGANYGYTF	GMFNMLSTVLGVS	1
CSARDSAASGGTDTQYF	GMFNMLSTVLGVS	1
CSIVGNTEAFF	GMFNMLSTVLGVS	1
CASSATGLRGNQPQHF	GMFNMLSTVLGVS	1
CASSVVGAGADTQYF	GMFNMLSTVLGVS	1
CASSGGVSGQETQYF	GMFNMLSTVLGVS	1
CASSWGTGSGNTEAFF	GMFNMLSTVLGVS	1
CASSLASGGLNEQFF	GMFNMLSTVLGVS	1
CSARDGGGLDEQFF	GMFNMLSTVLGVS	1
CASSYEGTEAFF	PKYVKQNTLKLAT	1
CASSESGTGDYEQYF	PKYVKQNTLKLAT	1
CASSLGQGEQYF	PKYVKQNTLKLAT	1
CASSWDRGDGDTQYF	PKYVKQNTLKLAT	1
CASSPTQGHSGNTIYF	PKYVKQNTLKLAT	1
CASNGGGAVDTQYF	PKYVKQNTLKLAT	1
CASSPFGTGNTIYF	PKYVKQNTLKLAT	1
CASSLFRGPYEQYF	PKYVKQNTLKLAT	1
CASSSVLSGANVLTF	PKYVKQNTLKLAT	1
CASSLSQGGEAFF	PKYVKQNTLKLAT	1
CSARGLQGDYNSPLHF	QARQMVQAMRTIGTHP	1
CASSQDLPGSNQPQHF	QARQMVQAMRTIGTHP	1
CSARDLQGSYNSPLHF	QARQMVQAMRTIGTHP	1
CASSRTSADTQYF	QARQMVQAMRTIGTHP	1
CASSVQGGNTEAFF	QARQMVQAMRTIGTHP	1
CASSVNNRGTEQYF	QARQMVQAMRTIGTHP	1
CASRGYNEQFF	QARQMVQAMRTIGTHP	1
CASSRGLGNTIYF	QARQMVQAMRTIGTHP	1
CSATRAGRAYNEQFF	QARQMVQAMRTIGTHP	1
CASSLAGAPGADTQYF	QARQMVQAMRTIGTHP	1
CASRPPGSSNQPQHF	QARQMVQAMRTIGTHP	1
CASSLDSSYEQYF	QARQMVQAMRTIGTHP	1
CSARQPGAGFSPLHF	QARQMVQAMRTIGTHP	1
CASRATGPDEQYF	QARQMVQAMRTIGTHP	1
CASSQDAEGDYGYTF	QARQMVQAMRTIGTHP	1
CASSLVGSRGAYNEQFF	QARQMVQAMRTIGTHP	1
CASSLGTGANGYTF	QARQMVQAMRTIGTHP	1
CASSLKRNYSPLHF	QARQMVQAMRTIGTHP	1
CASKRGRSNTDTQYF	QARQMVQAMRTIGTHP	1
CASSIRTGNSPLHF	QARQMVQAMRTIGTHP	1
CASSQGGQGAWNEQFF	QARQMVQAMRTIGTHP	1
CASSEPGQQNTEAFF	QARQMVQAMRTIGTHP	1
CSVEVSGAETQYF	QARQMVQAMRTIGTHP	1
CASSYRDSAKNIQYF	QARQMVQAMRTIGTHP	1
CASSHSGAQYF	QARQMVQAMRTIGTHP	1
CASSPGQGPRYQETQYF	QARQMVQAMRTIGTHP	1
CASSSPSGGAPYNEQFF	SGPLKAEIAQRLED	1
CATSALNEQFF	SGPLKAEIAQRLED	1
CASSALSRGSYGYTF	SGPLKAEIAQRLED	1
CASRQGRDRGPDSPLHF	SGPLKAEIAQRLED	1
CASSSLHSATNEKLFF	SGPLKAEIAQRLED	1
CASSASRDRGYTDTQYF	SGPLKAEIAQRLED	1
CASSSQGSTDTQYF	SGPLKAEIAQRLED	1
CASSFPSGGRIDTQYF	SGPLKAEIAQRLED	1
CASSQTGWTEAFF	SGPLKAEIAQRLED	1
CASSSQMRTVITDTQYF	SGPLKAEIAQRLED	1
CASSYSLGIYGYTF	SGPLKAEIAQRLED	1
CASSLGRDRGFKETQYF	SGPLKAEIAQRLED	1
CASSSTTSASTDTQYF	SGPLKAEIAQRLED	1
CASSFGGSGANVLTF	SGPLKAEIAQRLED	1
CASSQVGGNTGELFF	SGPLKAEIAQRLED	1
CAWNKGTGRGYTF	SGPLKAEIAQRLED	1
CASSPSRGTPYQETQYF	SGPLKAEIAQRLED	1
CASSLLYGLNQPQHF	SGPLKAEIAQRLED	1
CASSQVYDGYTF	SGPLKAEIAQRLED	1
CASSFPSGGAPDTQYF	SGPLKAEIAQRLED	1
CASSQEVLKSPLHF	SGPLKAEIAQRLED	1
CASSLLGGNTEAFF	SGPLKAEIAQRLED	1
CASSLGRDRGPDSPLHF	SGPLKAEIAQRLED	1
CASSISRGRDYGYTF	SGPLKAEIAQRLED	1
CASSFGTSGNNEQFF	GLIYNRMGAVTTEV	1
CASSEAGASGYTF	GLIYNRMGAVTTEV	1
CASSRDSSFNQPQHF	GLIYNRMGAVTTEV	1
CASTPSWGGYTF	GLIYNRMGAVTTEV	1
CASSPGGQLKNIQYF	PKYVKQNTLKLAT	1
CASSLGLAGNTDTQYF	PKYVKQNTLKLAT	1
CASSVTPQGTEAFF	PKYVKQNTLKLAT	1
CASSDSGTYNEQFF	PKYVKQNTLKLAT	1
CASSQEGGGRYGYTF	PKYVKQNTLKLAT	1
CASRADREREQFF	PKYVKQNTLKLAT	1
CASSLDDSGFYEQYF	PKYVKQNTLKLAT	1
CASTSPGKPYEQYF	PKYVKQNTLKLAT	1
CASSGDGYGYTF	PKYVKQNTLKLAT	1
CASSPGQGLRRETQYF	PKYVKQNTLKLAT	1
CASSSVLSGANVLTF	DPFRLLQNSQVFS	1
CSVAGTGDLNQPQHF	DPFRLLQNSQVFS	1
CASTNIISGANVLTF	DPFRLLQNSQVFS	1
CASTPILSGVNEQYF	DPFRLLQNSQVFS	1
CASTARLAGTPNTQYF	DPFRLLQNSQVFS	1
CSVGTGGTNEKLFF	DPFRLLQNSQVFS	1
CATAAGTGGNEQYF	DPFRLLQNSQVFS	1
CASSSILSGANVLTF	DPFRLLQNSQVFS	1
CASSVQRGVGYTF	DPFRLLQNSQVFS	1
CASSPGGSSYEQYF	DPFRLLQNSQVFS	1
CASSRPSTPNTEAFF	DPFRLLQNSQVFS	1
CASSLVDGDIQYF	DPFRLLQNSQVFS	1
CASSYAGLGSGANVLTF	DPFRLLQNSQVFS	1
CSARDQVRANYGYTF	DPFRLLQNSQVFS	1
CASSLVWSYNSPLHF	DPFRLLQNSQVFS	1
CASSLQGFLLSYEQYF	DPFRLLQNSQVFS	1
CASSLVFGGVNEQYF	DPFRLLQNSQVFS	1
CASSERLAGFTGELFF	DPFRLLQNSQVFS	1
CASSLRTYTGELFF	DPFRLLQNSQVFS	1
CASSLARSNTEAFF	DPFRLLQNSQVFS	1
CASRQNYGYTF	DPFRLLQNSQVFS	1
CASSPQDYGYTF	DPFRLLQNSQVFS	1
CASSLVNTGELFF	DPFRLLQNSQVFS	1
CASSLGSGVSNYGYTF	DPFRLLQNSQVFS	1
CSAYRGMNTEAFF	DPFRLLQNSQVFS	1
CASSLDGAGRADTQYF	GLIYNRMGAVTTEV	1
CASSQDLGTGYSPLHF	GLIYNRMGAVTTEV	1
CASNWGPLDYGYTF	GLIYNRMGAVTTEV	1
CASSKSGPVSPEAFF	GLIYNRMGAVTTEV	1
CASSFNRGGTEAFF	GLIYNRMGAVTTEV	1
CASSLASPNVLTF	GLIYNRMGAVTTEV	1
CASSLVGGNVNTGELFF	GLIYNRMGAVTTEV	1
CASSHDWGGTQYF	GLIYNRMGAVTTEV	1
CAISESSAEISGYTF	GLIYNRMGAVTTEV	1
CASSPEGTSGYNEQFF	GLIYNRMGAVTTEV	1
CASSFYGTSGYNEQFF	GLIYNRMGAVTTEV	1
CAISPETSSLGFF	GLIYNRMGAVTTEV	1
CASSLFASVGELFF	GLIYNRMGAVTTEV	1
CASSLDLGTGIGEQYF	GLIYNRMGAVTTEV	1
CASSAGEANYGYTF	GLIYNRMGAVTTEV	1
CASSLRDPGRVYAEAFF	GLIYNRMGAVTTEV	1
CASSLQQFEQYF	GLIYNRMGAVTTEV	1
CASSQDLGPLNSPLHF	GLIYNRMGAVTTEV	1
CASRRDTRNQPQHF	GLIYNRMGAVTTEV	1
CASNVVEGAEQYF	GLIYNRMGAVTTEV	1
CASSATGGSYEQYF	GLIYNRMGAVTTEV	1
CASSPIGYGYTF	GLIYNRMGAVTTEV	1
CASRRQGREKLFF	GLIYNRMGAVTTEV	1
CASSLDGGASREQYF	GLIYNRMGAVTTEV	1
CASSLDPPGGGNTIYF	GLIYNRMGAVTTEV	1
CASSLDQLAGGLGNEQFF	GLIYNRMGAVTTEV	1
CASSFDWGAEAFF	GLIYNRMGAVTTEV	1
CASSLSSGGTYEQYF	GLIYNRMGAVTTEV	1
CASSLARNYGYTF	GLIYNRMGAVTTEV	1
CASSPRGGGGGETQYF	GLIYNRMGAVTTEV	1
CASSRGGRYQETQYF	GLIYNRMGAVTTEV	1
CAWSAGRYTEAFF	GLIYNRMGAVTTEV	1
CASSSMGPTPGDTQYF	GLIYNRMGAVTTEV	1
CASSYLGSGEQYF	GLIYNRMGAVTTEV	1
CSARDQWRQGLHEQYF	GLIYNRMGAVTTEV	1
CASFAPDRGSYEQYF	GLIYNRMGAVTTEV	1
CASSFGDNQPQHF	GLIYNRMGAVTTEV	1
CASSQPQGPTDTQYF	GLIYNRMGAVTTEV	1
CASSSGQGVFYNEQFF	GMFNMLSTVLGVS	1
CASSVASGVTGELFF	GMFNMLSTVLGVS	1
CASSVVGAGTDTQYF	GMFNMLSTVLGVS	1
CASSYAGLGSGANVLTF	GMFNMLSTVLGVS	1
CSARRGGDTQYF	GMFNMLSTVLGVS	1
CASSVVGAGADTQYF	GMFNMLSTVLGVS	1
CASAKRTDYEQYF	GMFNMLSTVLGVS	1
CSAFGQASGNTIYF	GMFNMLSTVLGVS	1
CSARDMTASSTDTQYF	GMFNMLSTVLGVS	1
CASSVAGTGDYEQYF	PKYVKQNTLKLAT	1
CASSLSGQGALQPQHF	PKYVKQNTLKLAT	1
CASSPGQNEQFF	PKYVKQNTLKLAT	1
CATSGWGQGGTGELFF	PKYVKQNTLKLAT	1
CASSLGQGEAFF	PKYVKQNTLKLAT	1
CASGTFGGGSYNEQFF	PKYVKQNTLKLAT	1
CASSVAPGPDSPLHF	PKYVKQNTLKLAT	1
CASSDAGTGDYEQYF	PKYVKQNTLKLAT	1
CASSSATGSDNYNTEAFF	PKYVKQNTLKLAT	1
CASSQLGVQTEKLFF	PKYVKQNTLKLAT	1
CASSVAPGLGEGTQYF	PKYVKQNTLKLAT	1
CASSYEGGVESPLHF	PKYVKQNTLKLAT	1
CASSQDLESSYGYTF	PKYVKQNTLKLAT	1
CASSHGRSSGEAFF	PKYVKQNTLKLAT	1
CASSVAPGSSEAFF	PKYVKQNTLKLAT	1
CASHWSGGLNTGELFF	PKYVKQNTLKLAT	1
CASSLGQGSDGYTF	PKYVKQNTLKLAT	1
CASSPGQGEQYF	PKYVKQNTLKLAT	1
CASSKGQGEQYF	PKYVKQNTLKLAT	1
CASIPAPELAQETQYF	PKYVKQNTLKLAT	1
CASSFSPGDTEAFF	PKYVKQNTLKLAT	1
CATSAPSARTDTQYF	PKYVKQNTLKLAT	1
CATSDSIGGPYNEQFF	PKYVKQNTLKLAT	1
CASSYASLDQGEQYF	PKYVKQNTLKLAT	1
CASRGAGPTYNSPLHF	PKYVKQNTLKLAT	1
CASSVGPAENIQYF	PKYVKQNTLKLAT	1
CASREGGGNSYNEQFF	PKYVKQNTLKLAT	1
CATSEGTGRAEPQHF	PKYVKQNTLKLAT	1
CASAREPQMNTEAFF	PKYVKQNTLKLAT	1
CATSDPEGRDTQYF	PKYVKQNTLKLAT	1
CASTTQWGYAFF	PKYVKQNTLKLAT	1
CASSPGQWGGEQFF	PKYVKQNTLKLAT	1
CASRYGPYEQYF	PKYVKQNTLKLAT	1
CASRGDRVTYEQYF	PKYVKQNTLKLAT	1
CASSLEAGGQETQYF	QARQMVQAMRTIGTHP	1
CASSLGSYNEQFF	QARQMVQAMRTIGTHP	1
CASSLGGVGEKLFF	QARQMVQAMRTIGTHP	1
CASSSGSGGASNEQFF	QARQMVQAMRTIGTHP	1
CASSFGSYNEQFF	QARQMVQAMRTIGTHP	1
CASKFLTLPTYEQYF	QARQMVQAMRTIGTHP	1
CSARRLTGGSYNSPLHF	QARQMVQAMRTIGTHP	1
CASSYSFTPTARLGYTF	QARQMVQAMRTIGTHP	1
CSARDWGGSYNSPLHF	QARQMVQAMRTIGTHP	1
CSAQDRDSGNTIYF	QARQMVQAMRTIGTHP	1
CSAAAWDKYNEQFF	QARQMVQAMRTIGTHP	1
CASSLRIYTGELFF	QARQMVQAMRTIGTHP	1
CASSLGSYETQYF	QARQMVQAMRTIGTHP	1
CSAQDRDSGNTIYF	QARQMVQAMRTIGTHP	1
CASSDGARKSSYNSPLHF	QARQMVQAMRTIGTHP	1
CSARDLGGSYNSPLHF	QARQMVQAMRTIGTHP	1
CASSEQVAQETQYF	QARQMVQAMRTIGTHP	1
CASSLGGFEEQYF	QARQMVQAMRTIGTHP	1
CASSPPTSGDSNIQYF	QARQMVQAMRTIGTHP	1
CASSLGSYNEQFF	QARQMVQAMRTIGTHP	1
CSARGWGGRNYGYTF	QARQMVQAMRTIGTHP	1
CASSSFFTGGSNQPQHF	QARQMVQAMRTIGTHP	1
CASSLRDSFTEAFF	QARQMVQAMRTIGTHP	1
CASSTEGGSYTF	QARQMVQAMRTIGTHP	1
CSARGTGYNEQFF	QARQMVQAMRTIGTHP	1
CASSLGHSSYNSPLHF	QARQMVQAMRTIGTHP	1
CSAWPIQYSNQPQHF	QARQMVQAMRTIGTHP	1
CASSEGSYNEQFF	QARQMVQAMRTIGTHP	1
CASSLRGAGTEAFF	QARQMVQAMRTIGTHP	1
CASTSTGQYPEAFF	QARQMVQAMRTIGTHP	1
CSARDQVRANYGYTF	QARQMVQAMRTIGTHP	1
CASSLQGFLLSYEQYF	QARQMVQAMRTIGTHP	1
CASSLGAGANVLTF	QARQMVQAMRTIGTHP	1
CASSYQGGGGTDTQYF	QARQMVQAMRTIGTHP	1
CASSLALSGNEQFF	QARQMVQAMRTIGTHP	1
CASSSGTGYEQYF	QARQMVQAMRTIGTHP	1
CASSHGIYNEQFF	QARQMVQAMRTIGTHP	1
CASSSQGNTIYF	QARQMVQAMRTIGTHP	1
CASSFPSGGVFSQYF	SGPLKAEIAQRLED	1
CASSERDRGSYGYTF	SGPLKAEIAQRLED	1
CASSFLSGGSKETQYF	SGPLKAEIAQRLED	1
CATAGLNEQFF	SGPLKAEIAQRLED	1
CASTRGGQGGTEAFF	SGPLKAEIAQRLED	1
CASSARSTEAFF	SGPLKAEIAQRLED	1
CASSLAGDRGPNQPQHF	SGPLKAEIAQRLED	1
CASSLAAGGRYEQFF	SGPLKAEIAQRLED	1
CASSSRDRGRWEQYF	SGPLKAEIAQRLED	1
CASRTGSISNQPQHF	SGPLKAEIAQRLED	1
CASSLGTRNEQFF	SGPLKAEIAQRLED	1
CASSSPTGSRNTEAFF	PKYVKQNTLKLAT	1
CASSIEGIYGYTF	PKYVKQNTLKLAT	1
CATQGVGGNTIYF	PKYVKQNTLKLAT	1
CATSPGTGITNQPQHF	PKYVKQNTLKLAT	1
CATSDPGGGTDTQYF	PKYVKQNTLKLAT	1
CASTGGGGPFQAFF	PKYVKQNTLKLAT	1
CASRTDMNSPLHF	PKYVKQNTLKLAT	1
CASSTPGGGTDTQYF	PKYVKQNTLKLAT	1
CASSSSGDGYTF	PKYVKQNTLKLAT	1
CASSLGGSDLYGYTF	PKYVKQNTLKLAT	1
CASTPGAGVNTDTQYF	PKYVKQNTLKLAT	1
CASSLGDRGLEQYF	PKYVKQNTLKLAT	1
CASSLGGRPEAFF	PKYVKQNTLKLAT	1
CASLVGGGDTGELFF	PKYVKQNTLKLAT	1
CASSLGGRPEAFF	PKYVKQNTLKLAT	1
CASSFQGWETQYF	PKYVKQNTLKLAT	1
CASSLGGRPEAFF	PKYVKQNTLKLAT	1
CASRTDMNSPLHF	PKYVKQNTLKLAT	1
CASSLQGTNEKLFF	PKYVKQNTLKLAT	1
CASSTTGTAFYEQYF	PKYVKQNTLKLAT	1
CAWSKASWGAEAFF	PKYVKQNTLKLAT	1
CASSPRTGDQPQHF	PKYVKQNTLKLAT	1
CASSEFWDGYTF	PKYVKQNTLKLAT	1
CASSSGPAFF	PKYVKQNTLKLAT	1
CASSSIKGAFF	PKYVKQNTLKLAT	1
CASSPGGGRNTYEQYF	PKYVKQNTLKLAT	1
CASSGPGQGTDTQYF	PKYVKQNTLKLAT	1
CASSLTGWQYF	PKYVKQNTLKLAT	1
CASVASPGTSALDYEQYF	PKYVKQNTLKLAT	1
CASSSGPPAKAFF	PKYVKQNTLKLAT	1
CASTPSPGVSSIGYEQYF	PKYVKQNTLKLAT	1
CASSQEEGGQPQHF	PKYVKQNTLKLAT	1
CASRPEKETGELFF	PKYVKQNTLKLAT	1
CASRPEKETGELFF	PKYVKQNTLKLAT	1
CASSYVGQGLGETQYF	PKYVKQNTLKLAT	1
CASSLEGQDYEQYF	PKYVKQNTLKLAT	1
CASSLDGLAGGPSF	PKYVKQNTLKLAT	1
CASSRDWETYEQYF	PKYVKQNTLKLAT	1
CASSLGNGNTIYF	PKYVKQNTLKLAT	1
CASSQDPTGYSGANVLTF	PKYVKQNTLKLAT	1
CASSVGRNTEAFF	PKYVKQNTLKLAT	1
CASSQSLHGATNEKLFF	PKYVKQNTLKLAT	1
CASSQSLHGATNEKLFF	PKYVKQNTLKLAT	1
CASRGGGNIQYF	PKYVKQNTLKLAT	1
CSADGGDIWSDEQFF	PKYVKQNTLKLAT	1
CATSDFGEGTDTQYF	PKYVKQNTLKLAT	1
CATQQVGANVLTF	PKYVKQNTLKLAT	1
CATSDPTSGREDEQYF	PKYVKQNTLKLAT	1
CATRPGTSDYNEQFF	PKYVKQNTLKLAT	1
CATSDFGEGTDTQYF	PKYVKQNTLKLAT	1
CATSDFGEGTDTQYF	PKYVKQNTLKLAT	1
CATSDFGEGTDTQYF	PKYVKQNTLKLAT	1
CASSFPPGQGVQGAFF	PKYVKQNTLKLAT	1
CASSSHGGGSYGYTF	PKYVKQNTLKLAT	1
CASTFSPGTRSRDTQYF	PKYVKQNTLKLAT	1
CASSFFSYEQYF	PKYVKQNTLKLAT	1
CASSSAGGTGMNYGYTF	PKYVKQNTLKLAT	1
CASSTPGTGSSPLHF	PKYVKQNTLKLAT	1
CASIPSAGTSGKEVTDTQYF	PKYVKQNTLKLAT	1
CASSSSGGGTDTQYF	PKYVKQNTLKLAT	1
CASSGIAGGPSYEQYF	PKYVKQNTLKLAT	1
CASSSHGGGSYGYTF	PKYVKQNTLKLAT	1
CASSTPGTGSSPLHF	PKYVKQNTLKLAT	1
CASRDSGSSTDTQYF	PKYVKQNTLKLAT	1
CASSYTDNGNTIYF	PKYVKQNTLKLAT	1
CASKPGQLLNYGYTF	PKYVKQNTLKLAT	1
CATSDPGQGAGDTQYF	PKYVKQNTLKLAT	1
CASWVGGREDSAQHF	PKYVKQNTLKLAT	1
CASPPAGDITGETQYF	PKYVKQNTLKLAT	1
CASSPGGGRGSYEQYF	PKYVKQNTLKLAT	1
CASSQGDRGNIQYF	PKYVKQNTLKLAT	1
CASSYDTNTEAFF	PKYVKQNTLKLAT	1
CASSLDGQDYEQYF	PKYVKQNTLKLAT	1
CATGPGTENTEAFF	PKYVKQNTLKLAT	1
CASSLAPPGRLNSPLHF	PKYVKQNTLKLAT	1
CASSLDLGLGSPLHF	PKYVKQNTLKLAT	1
CASSLDGRQSNTEAFF	PKYVKQNTLKLAT	1
CASSLQGIYTF	PKYVKQNTLKLAT	1
CASSPGVAGSSYNEQFF	PKYVKQNTLKLAT	1
CASSLISNTEAFF	PKYVKQNTLKLAT	1
CASSLVVGAGTEAFF	PKYVKQNTLKLAT	1
CASSLGTGGINYGYTF	PKYVKQNTLKLAT	1
CASSLQVNTFSSGNTIYF	PKYVKQNTLKLAT	1
CATRESSGNTIYF	PKYVKQNTLKLAT	1
CASRTEDNSPLHF	PKYVKQNTLKLAT	1
CASSFGAKAGEQFF	PKYVKQNTLKLAT	1
CASSLASGGVNEQFF	PKYVKQNTLKLAT	1
CASSLGQNSGNTDTQYF	PKYVKQNTLKLAT	1
CASSWGVETQYF	PKYVKQNTLKLAT	1
CASREDRGVSKAEQYF	PKYVKQNTLKLAT	1
CASSSQGLHEQYF	PKYVKQNTLKLAT	1
CASGAGRDRNTDTQYF	PKYVKQNTLKLAT	1
CASTRQNSNQPQHF	PKYVKQNTLKLAT	1
CASSQGRRNGYTF	PKYVKQNTLKLAT	1
CASSRGPSSEQYF	PKYVKQNTLKLAT	1
CATSREGGGYNEQFF	PKYVKQNTLKLAT	1
CATSRDAGEVETQYF	PKYVKQNTLKLAT	1
CASSPGLSVGEQFF	PKYVKQNTLKLAT	1
CASSASQGSHRLDTEAFF	PKYVKQNTLKLAT	1
CASKTQGGSLRGYTF	PKYVKQNTLKLAT	1
CASRSPGGYYGYTF	PKYVKQNTLKLAT	1
CASDRVGSNQPQHF	PKYVKQNTLKLAT	1
CASDYTGDGNQPQHF	PKYVKQNTLKLAT	1
CASTLGPGRDQGAQHF	PKYVKQNTLKLAT	1
CASSFKRGLGDEQFF	PKYVKQNTLKLAT	1
CASSLLRTDTDTQYF	PKYVKQNTLKLAT	1
CASSTPRGFRYEQYF	PKYVKQNTLKLAT	1
CASSDGLQGNTEAFF	PKYVKQNTLKLAT	1
CASRGDLEGYTF	PKYVKQNTLKLAT	1
CASPATEYNEQFF	PKYVKQNTLKLAT	1
CAKATRDTQYF	PKYVKQNTLKLAT	1
CASRLAKGRFETQYF	PKYVKQNTLKLAT	1
CSAEMDAAGAFF	PKYVKQNTLKLAT	1
CSALVKYKNTEAFF	PKYVKQNTLKLAT	1
CSASGSGGKTEAFF	PKYVKQNTLKLAT	1
CSARDFSYGYTF	PKYVKQNTLKLAT	1
CSARLPAGDGYTF	PKYVKQNTLKLAT	1
CSASGHRTDGNTIYF	PKYVKQNTLKLAT	1
CSARDSGDGGYQPQHF	PKYVKQNTLKLAT	1
CSVELAGGGGNEQFF	PKYVKQNTLKLAT	1
CSAIRTSGTGTQYF	PKYVKQNTLKLAT	1
CSASLGTGQETQYF	PKYVKQNTLKLAT	1
CSASSGTQETQYF	PKYVKQNTLKLAT	1
CSAVYQETQYF	PKYVKQNTLKLAT	1
CATSAEGGRRSEQFF	PKYVKQNTLKLAT	1
CASSPGVQGTVQPQHF	PKYVKQNTLKLAT	1
CASRTALAGGLRGSYNEQFF	PKYVKQNTLKLAT	1
CASSLGQPNTEAFF	PKYVKQNTLKLAT	1
CASTGLGRGGTEAFF	PKYVKQNTLKLAT	1
CASSSSGGSWGYTF	PKYVKQNTLKLAT	1
CATQGQLNYGYTF	PKYVKQNTLKLAT	1
CASTQDGTNEKLFF	PKYVKQNTLKLAT	1
CASSLSNQPQHF	PKYVKQNTLKLAT	1
CASAVRSPLHF	PKYVKQNTLKLAT	1
CASLRLGEGGEQFF	PKYVKQNTLKLAT	1
CASSRGLTINEQFF	PKYVKQNTLKLAT	1
CASTSGGTYNEQFF	PKYVKQNTLKLAT	1
CASSLLDRVLAGELFF	PKYVKQNTLKLAT	1
CASSLNPLRRIQETQYF	PKYVKQNTLKLAT	1
CASSSPTSGSLQYEQYF	PKYVKQNTLKLAT	1
CASSSQGYEQYF	PKYVKQNTLKLAT	1
CASSSSGGASYEQYF	PKYVKQNTLKLAT	1
CSVAGTGSNQPQHF	PKYVKQNTLKLAT	1
CSAIGPGRFETQYF	PKYVKQNTLKLAT	1
CSGAGEGIEQYF	PKYVKQNTLKLAT	1
CSVKVGYEQYF	PKYVKQNTLKLAT	1
CASSQSGGLKDTQYF	PKYVKQNTLKLAT	1
CASSQVEETQYF	PKYVKQNTLKLAT	1
CASDRGHTEAFF	PKYVKQNTLKLAT	1
CAWSGRRGVTEAFF	PKYVKQNTLKLAT	1
CAWSVGLGRQPQHF	PKYVKQNTLKLAT	1
CAWGGGDTQYF	PKYVKQNTLKLAT	1
CAWSLEADTQYF	PKYVKQNTLKLAT	1
CASSRQTGGTAEAFF	PKYVKQNTLKLAT	1
CASSLAPGQHNEQFF	PKYVKQNTLKLAT	1
CASSRDLTDTQYF	PKYVKQNTLKLAT	1
CASSRENTEAFF	PKYVKQNTLKLAT	1
CASSLASGSRYNEQFF	PKYVKQNTLKLAT	1
CASSYGGTGGLTEQYF	PKYVKQNTLKLAT	1
CASSTDGGYEQYF	PKYVKQNTLKLAT	1
CASSVGYNQPQHF	PKYVKQNTLKLAT	1
CASSDRGANSYNEQFF	PKYVKQNTLKLAT	1
CASPQGFPNYEQYF	PKYVKQNTLKLAT	1
CASSEEGRDEQYF	PKYVKQNTLKLAT	1
CASSEVVWGAEQYF	PKYVKQNTLKLAT	1
CASTRGAIEYYGYTF	PKYVKQNTLKLAT	1
CASSDSGGVHNEQFF	PKYVKQNTLKLAT	1
CASLAGTLTPMNTEAFF	PKYVKQNTLKLAT	1
CASSSTGRVLTEAFF	PKYVKQNTLKLAT	1
CASSYSHYTEAFF	PKYVKQNTLKLAT	1
CASRGDHEQFF	PKYVKQNTLKLAT	1
CASSQGGGGGAGELFF	PKYVKQNTLKLAT	1
CASSHGTGAYEQYF	PKYVKQNTLKLAT	1
CASSPERRAYEQYF	PKYVKQNTLKLAT	1
CASSPGTSGAYEQYF	PKYVKQNTLKLAT	1
CASSYAGAGAYEQYF	PKYVKQNTLKLAT	1
CASSYSSGGPREQYF	PKYVKQNTLKLAT	1
CASSYSEIQAAFF	PKYVKQNTLKLAT	1
CASSPQGGRHGYTF	PKYVKQNTLKLAT	1
CATRNLLAGGNEQFF	PKYVKQNTLKLAT	1
CASSLDRTSGTNEQFF	PKYVKQNTLKLAT	1
CASTAELKGAEGYTF	PKYVKQNTLKLAT	1
CASSLLGNEQFF	PKYVKQNTLKLAT	1
CASSLMGGVPYNEQFF	PKYVKQNTLKLAT	1
CASSLMGGVPYNEQFF	PKYVKQNTLKLAT	1
CASSLMGGVPYNEQFF	PKYVKQNTLKLAT	1
CASSLMGGVPYNEQFF	PKYVKQNTLKLAT	1
CASSPDGSSYNEQFF	PKYVKQNTLKLAT	1
CASSPGTGLDTQYF	PKYVKQNTLKLAT	1
CASSSGLAGGLETQYF	PKYVKQNTLKLAT	1
CASSPLAGPLYEQYF	PKYVKQNTLKLAT	1
CASSLGGTYSNQPQHF	PKYVKQNTLKLAT	1
CASSSSGQDANEQFF	PKYVKQNTLKLAT	1
CASSSSGQDANEQFF	PKYVKQNTLKLAT	1
CASSSSGQDANEQFF	PKYVKQNTLKLAT	1
CASRRPQEGTEAFF	PKYVKQNTLKLAT	1
CASSLAGGSDNEQFF	PKYVKQNTLKLAT	1
CASSFSGVSGANVLTF	PKYVKQNTLKLAT	1
CASSVEGTGYYEQYF	PKYVKQNTLKLAT	1
CASRLQGWNSPLHF	VVRHCPHHERCSDSD	1
CASSYSQAWGQPQHF	RNTFRHSVVVPCE	1
CASSISAGGDGYTF	HYNYMCNSSCMGSMN	1
CASSLVNTEAFF	HYNYMCNSSCMGSMN	1
CASSSRDYEQYF	SCMGGMNWRPILTII	1
CASSLGDRGNEKLFF	NSKEETGHLENGN	1
CASSKGPGGNYEQYF	NSKEETGHLENGN	1
CASSASTGRNQPQHF	DPPALASTNAEVT	1
CASSLARRQYGYTF	DPPALASTNAEVT	1
CASSSQGFYNIQYF	DPPALASTNAEVT	1
CASSIRNYSNQPQHF	DPPALASTNAEVT	1
CASSLRTGQNTEAFF	DPPALASTNAEVT	1
CASSGGTPYNSPLHF	DPPALASTNAEVT	1
CASTPQVNYGYTF	GYNSYSVSNSEKHIM	1
CASTLQANYGYTF	GYNSYSVSNSEKHIM	1
CAWSALAGARDTQYF	GAVGVGKSAL	1
CASSLGLPGTDTQYF	GAVGVGKSAL	1
CSAPPLAGDETQYF	YVMAYVMAGVGS	1
CASTTGTSGQNTGELFF	KALARALKEGRIR	1
CASTAGLLGSSYNEQFF	NHVVDISKSGLITIA	1
CASNEGNSGNTIYF	GDFGLATEKSRWSGS	1
CASGARQIPYTF	GDFGLATEKSRWSGS	1
CASSLSAAGGGYGYTF	GDFGLATEKSRWSGS	1
CASSFEETQYF	TAAQAAVVRFQEAAN	1
CASSPEETQYF	TAAQAAVVRFQEAAN	1
CASSLEETQYF	TAAQAAVVRFQEAAN	1
CASSVALAGAEYF	MHVSFVMAYPEMLAA	1
CASSVALASGANVLTF	MHVSFVMAYPEMLAA	1
CASSVALQGVHTQYF	MHVSFVMAYPEMLAA	1
CASSVALATGEQYF	MHVSFVMAYPEMLAA	1
CASSLIEGGTEAFF	PSPSMGRDIKVQFQS	1
CASSLIEGLEQYF	PSPSMGRDIKVQFQS	1
CASSLIENTEAFF	PSPSMGRDIKVQFQS	1
CASSLIEQQPQHF	PSPSMGRDIKVQFQS	1
CASSLGQGHYNEQFF	MSQIMYNYPAMLGHA	1
CASSPGQGHYNEQFF	MSQIMYNYPAMLGHA	1
CSARAGGGEAKNIQYF	AAVVRFQEAANKQKQ	1
CSARASGGEAKNIQYF	AAVVRFQEAANKQKQ	1
CSARKQGNEQFF	PPQIAANRSQLISLV	1
CSARGQGNEQYF	PPQIAANRSQLISLV	1
CASSPGTESNQPQHF	STRQALRPRADGPVG	1
CASSFGTESNQPQHF	STRQALRPRADGPVG	1
CASSLGTESNQPQHF	STRQALRPRADGPVG	1
CAISFVTESNQPQHF	STRQALRPRADGPVG	1
CASSFVTESNQPQHF	STRQALRPRADGPVG	1
CASSPGTESNSPLHF	STRQALRPRADGPVG	1
CASSRGTESNTEAFF	STRQALRPRADGPVG	1
CASSSGTESNQPQHF	STRQALRPRADGPVG	1
CASSTGTESNQPQHF	STRQALRPRADGPVG	1
CASTGGTESNQPQHF	STRQALRPRADGPVG	1
CASSLRSRGYEQYF	LTDEQRAAALEKAAA	1
CASSLRSRSYEQYF	LTDEQRAAALEKAAA	1
CASSLRSRAYEQYF	LTDEQRAAALEKAAA	1
CASSYSGGVGETQYF	PKYVKQNTLKLAT	1
CASSYSGGVGETQYF	PKYVKQNTLKLRT	1
CASSDGTFTEAFF	PKYVKQNTLKLAT	1
CASSMSPGPRESPLHF	PKYVKQNTLKLAT	1
CASSMSPGPRESPLHF	PKYVKQNTLKLRT	1
CASSDAGLGDYEQYF	PKYVKQNTLKLAT	1
CASSDAGLGDYEQYF	PKYVKQNTLKLRT	1
CASSPPGAGEGETQYF	PKYVKQNTLKLAT	1
CASSPPGAGEGETQYF	PKYVKQNTLKLRT	1
CASSLIAEEEGYGYTF	PKYVKQNTLKLAT	1
CASSTTGSTDTQYF	PKYVKQNTLKLAT	1
CASSLGLAGGGDTQYF	PKYVKQNTLKLAT	1
CASTPGTGDVQPQHF	PKYVKQNTLKLAT	1
CASSPLSQGVRGYTF	PKYVKQNTLKLAT	1
CASSPLSQGVRGYTF	PKYVKQNTLKLAR	1
CASSRTGSTDTQYF	PKYVKQNTLKLAT	1
CASSTDRGPYEQYF	PKYVKQNTLKLAT	1
CATSDESYGYTF	PKYVKQNTLKLAT	1
CASSRLRGPYEQYF	PKYVKQNTLKLAT	1
CASSYDPSPTYEQYF	PKYVKQNTLKLAT	1
CASSDAGLGDYEQYF	PKYVKQNTLKLAT	1
CAYTTSGAVTDTQYF	PKYVKQNTLKLAT	1
CASSEGFGAFQPQHF	PKYVKQNTLKLAT	1
CASSRRTSGGSDTQYF	FRDYVDRFYKTLRAEQASQE	1
CAIRRTGLPGNEQFF	FRDYVDRFYKTLRAEQASQE	1
CASNRTGLPGNEQFF	FRDYVDRFYKTLRAEQASQE	1
CASSEEGDTQYF	FRDYVDRFYKTLRAEQASQE	1
CASSEEWDTQYF	FRDYVDRFYKTLRAEQASQE	1
CASSEGGYGYTF	FRDYVDRFYKTLRAEQASQE	1
CASSEKGDTQYF	FRDYVDRFYKTLRAEQASQE	1
CASSENRVTTDYPNEKLFF	FRDYVDRFYKTLRAEQASQE	1
CASSKNRVTTAEPNEKLFF	FRDYVDRFYKTLRAEQASQE	1
CASSKNRVTTDYPNEKLFF	FRDYVDRFYKTLRAEQASQE	1
CASSPTGLPGNEQFF	FRDYVDRFYKTLRAEQASQE	1
CASSRTGLPGNEQFF	FRDYVDRFYKTLRAEQASQE	1
CASSRTGVQGNEQFF	FRDYVDRFYKTLRAEQASQE	1
CASWEGGTVGVTQYF	FRDYVDRFYKTLRAEQASQE	1
CASRRLAGASYNEQFF	FRDYVDRFYKTLRAEQASQE	1
CASRRRTSASSDEQYF	FRDYVDRFYKTLRAEQASQE	1
CASSEALRDSGGQYF	FRDYVDRFYKTLRAEQASQE	1
CASSRRTSGGTDTQYF	FRDYVDRFYKTLRAEQASQE	1
CASTKLALAYEHYF	FRDYVDRFYKTLRAEQASQE	1
CASTKLALAYEQYF	FRDYVDRFYKTLRAEQASQE	1
CASTQLAGASYHDFFF	FRDYVDRFYKTLRAEQASQE	1
CATRRLAGASYNEQFF	FRDYVDRFYKTLRAEQASQE	1
CASRRLAGASYNEQFF	FRDYVDRFYKTLRAEQASQE	1
CASSEALRDSGGQYF	FRDYVDRFYKTLRAEQASQE	1
CASSRRNSGGTDTQYF	FRDYVDRFYKTLRAEQASQE	1
CASSRRTSGGSDTQYF	FRDYVDRFYKTLRAEQASQE	1
CASSRRTSGGTDTQYF	FRDYVDRFYKTLRAEQASQE	1
CASTKLALAYEQYF	FRDYVDRFYKTLRAEQASQE	1
CASTRGSTDTQYF	FRDYVDRFYKTLRAEQASQE	1
CAISELASGTDTQYF	FRDYVDRFYKTLRAEQASQE	1
CASNELASGTDTQYF	FRDYVDRFYKTLRAEQASQE	1
CASSELASGANNPYF	FRDYVDRFYKTLRAEQASQE	1
CASSELASGTDTQYF	FRDYVDRFYKTLRAEQASQE	1
CASSRRTSGGTDTQYF	FRDYVDRFYKTLRAEQASQE	1
CAGSRRTSGGADTQYF	FRDYVDRFYKTLRAEQASQE	1
CARSELASGTDTQYF	FRDYVDRFYKTLRAEQASQE	1
CASIRTGSSPLHF	FRDYVDRFYKTLRAEQASQE	1
CASSARGAWGNQPQHF	FRDYVDRFYKTLRAEQASQE	1
CASSELASGTDTQYF	FRDYVDRFYKTLRAEQASQE	1
CASSRRTIGGADTQYF	FRDYVDRFYKTLRAEQASQE	1
CASSRRTSGGADTQYF	FRDYVDRFYKTLRAEQASQE	1
CASRGLVDTGELFF	FRDYVDRFYKTLRAEQASQE	1
CASSELASGTDTQYF	FRDYVDRFYKTLRAEQASQE	1
CASSERQGIWIFF	FRDYVDRFYKTLRAEQASQE	1
CAIIRRTSGGTDTQYF	FRDYVDRFYKTLRAEQASQE	1
CAISELASGTDTQYF	FRDYVDRFYKTLRAEQASQE	1
CAISRRTSWGSDTQYF	FRDYVDRFYKTLRAEQASQE	1
CASSELASGTDTQYF	FRDYVDRFYKTLRAEQASQE	1
CASSRRTNGGADTHYF	FRDYVDRFYKTLRAEQASQE	1
CASSRRTSGGADTQYF	FRDYVDRFYKTLRAEQASQE	1
CASSRRTSGGTDTQYF	FRDYVDRFYKTLRAEQASQE	1
CASSRRTTVGTDTQYF	FRDYVDRFYKTLRAEQASQE	1
CASARLAARTDTQYF	FRDYVDRFYKTLRAEQASQE	1
CASRWGQGENQPQHF	FRDYVDRFYKTLRAEQASQE	1
CASSALAARTDTQYF	FRDYVDRFYKTLRAEQASQE	1
CASSDRRAGANVLTF	FRDYVDRFYKTLRAEQASQE	1
CASSEARRVNQPQHF	FRDYVDRFYKTLRAEQASQE	1
CASTRASTDTQYF	FRDYVDRFYKTLRAEQASQE	1
CASTRGSTDTQYF	FRDYVDRFYKTLRAEQASQE	1
CASARLAARTDTQYF	FRDYVDRFYKTLRAEQASQE	1
CASPRGSTDTQYF	FRDYVDRFYKTLRAEQASQE	1
CASRGDRGLGGYTF	FRDYVDRFYKTLRAEQASQE	1
CASSALAARTDTQYF	FRDYVDRFYKTLRAEQASQE	1
CASSALSARTDTQYF	FRDYVDRFYKTLRAEQASQE	1
CASSATVTNTGELFF	FRDYVDRFYKTLRAEQASQE	1
CASSDRRAGANVLTF	FRDYVDRFYKTLRAEQASQE	1
CASSDRRVGTNVLTF	FRDYVDRFYKTLRAEQASQE	1
CASSEARRVNQPQHF	FRDYVDRFYKTLRAEQASQE	1
CASSEGRAGGYTF	FRDYVDRFYKTLRAEQASQE	1
CASSEGSYYEQYF	FRDYVDRFYKTLRAEQASQE	1
CASSVLASGTDKQYF	FRDYVDRFYKTLRAEQASQE	1
CASSVLTSGGDEQYF	FRDYVDRFYKTLRAEQASQE	1
CASTRGSTDTQYF	FRDYVDRFYKTLRAEQASQE	1
CASARLAARTDTQYF	FRDYVDRFYKTLRAEQASQE	1
CASSALAARTDTQYF	FRDYVDRFYKTLRAEQASQE	1
CASSATVTNTGELFF	FRDYVDRFYKTLRAEQASQE	1
CASTRGSTDTQYF	FRDYVDRFYKTLRAEQASQE	1
CASTRGSTHTHYF	FRDYVDRFYKTLRAEQASQE	1
CASARLAARTDTQYF	FRDYVDRFYKTLRAEQASQE	1
CASSALAARTDTQYF	FRDYVDRFYKTLRAEQASQE	1
CASSATVTNTGELFF	FRDYVDRFYKTLRAEQASQE	1
CASSEARRVNQPQHF	FRDYVDRFYKTLRAEQASQE	1
CASSVLAARTDTQYF	FRDYVDRFYKTLRAEQASQE	1
CASTGLAARTDTQYF	FRDYVDRFYKTLRAEQASQE	1
CASTGRGSTDTQYF	FRDYVDRFYKTLRAEQASQE	1
CASSLERETQYF	GQVELGGGPGAESCQ	1
CASSLERETQYF	GQVELGGGSSPETCI	1
CASSLRRGDTIYF	GQVELGGGNAVEVCK	1
CASSLRRGDTIYF	GQVELGGGTPIESCQ	1
CASSLERETQYF	GQVELGGGNAVEVCK	1
CASSSTGLPYGYTF	PKYVKQNTLKLAT	1
CASSSTGLPYGYTF	PKYVKQNTLKLAT	1
CASSLADRVNTEAFF	VHFFKNIVTPRTPG	1
CASTYHGTGYF	GELIGILNAAKVPAD	1
CASTYHGTGYF	GELIGTLNAAKVPAD	1
CASSSRSSYEQYF	PKYVKQNTLKLAT	1
CASSSRSSYEQYF	PKYVKQNTLKLAT	1
CASSQIRETQYF	GELIGILNAAKVPAD	1
CASSVAVSAGTYEQYF	SGEGSFQPSQENP	1
CASSFRALAADTQYF	APQPELPYPQPGS	1
CASSFRFTDTQYF	APQPELPYPQPGS	1
CASSVRSTDTQYF	APQPELPYPQPG	1
CSAGVGGQETQYF	QPFPQPELPYP	1
CASRPRRDNEQFF	QPLALEGSLQKRG	1
CASRPRDPVTQYF	LQPLALEGSLQKRG	1
CASSTTPGTGTETQYF	PSGEGSFQPSQENPQ	1
CASSAGTSGEYEQYF	SGEGSFQPSQENP	1
CASSEARRYNEQFF	PSGEGSFQPSQENPQ	1
CSARDLTSGANNEQFF	ENPVVHFFKNIVTP	1
CSARDLTSGANNEQFF	MDFARVHFISALHGSG	1
CSARGGSYNSPLHF	FSWGAEGQRPGF	1
CATSALGDTQYF	NPVVHFFKNIVTPR	1
CSARGGSYNSPLHF	FSWGAEGQRPGFGSGG	1
CATSALGDTQYF	RLLMLFAKDVVSRN	1
CASSLRDGYTGELFF	QHIRCNIPKRISA	1
CATSALGDTQYF	QLVHFVRDFAQL	1
CASSLAQGGETQYF	QAFWIDLFETIG	1
CASSVAPGSDTQYF	APSGEGSFQPSQENPQ	1
CASSVAGTPSYEQYF	QPQQSFPEQEA	1
CASSNRGLGTDTQYF	GPQQSFPEQEA	1
CASSRLAGGMDEQFF	RFYKTLRAEQASQ	1
CASSGLAGGMDEQFF	RFYKTLRAEQASQ	1
CASSRLAGGMDEQFF	RFYKTLRAEQASQ	1
CASSRLAGGMDEQFF	RFYKTLRAEQASQ	1
CASSAGNTIYF	VEELYLVAGEEGCGGGGSL	1
CASSAGNTIYF	VEELYLVAGEEGCGGGGSL	1
CASSHGASTDTQYF	APFSEQEQPVLG	1
CASSSGGWGGGTEAFF	APFSEQEQPVLG	1
CASSLEGQGASEQFF	APMPMPELPYP	1
CASSFRALAADTQYF	AVVQSELPYPEGS	1
CASSLSASGGATDTQYF	GQVELGGGNAVEVCKGS	1
CASSLERDGYTF	GQVELGGGNAVEVCK	1
CASSLERETQYF	GQVELGGGNAVEVCKGS	1
CASSQGQDTEAFF	QPFPQPEQPFP	1
CSVALGSDTGELFF	LQPFPQPELPYGSGGS	1
CSVALGSDTGELFF	LQPFPQPELPYGSGGS	1
CASSLERETQYF	GQVELGGGPGAESCQ	1
CASSLERETQYF	GQVELGGGSSPETCI	1
CASSLRRGDTIYF	GQVELGGGNAVEVCK	1
CASSLRRGDTIYF	GQVELGGGTPIESCQ	1
CASSLERETQYF	GQVELGGGNAVEVCK	1
CASSLERDGYTF	GQVELGGGNAVEVCK	1
CASSLSASGGATDTQYF	GQVELGGGNAVEVCK	1
CASSFGVEDEQYF	LQPFPQPELPYPQPQ	1
CASSSLNTQYF	LQPFPQPELPYPQPQ	1
CASSIRSTDTQYF	LQPFPQPELPYPQPQ	1
CASSQVTLPTETQYF	LQPFPQPELPYPQPQ	1
CASNFGVEDEQYF	LQPFPQPELPYPQPQ	1
CASSLGVEDEQYF	LQPFPQPELPYPQPQ	1
CASSQVTLPTETQYF	LQPFPQPELPYPQPQ	1
CASGQVTLPTETQYF	LQPFPQPELPYPQPQ	1
CASSSLNTQYF	LQPFPQPELPYPQPQ	1
CASSQVTLPTGTQYF	LQPFPQPELPYPQPQ	1
CASGQVILPTETQYF	LQPFPQPELPYPQPQ	1
CASSQVTLPTETQYF	LQPFPQPELPYPQPQ	1
CASSLGGSTDTQYF	LQPFPQPELPYPQPQ	1
CSASSSGGASYNEQFF	LQPFPQPELPYPQPQ	1
CASSRTGQGGETQYF	LQPFPQPELPYPQPQ	1
CASSFGVEDEQYF	LQPFPQPELPYPQPQ	1
CASSLSFDSPLHF	LQPFPQPELPYPQPQ	1
CASSRSYGYTF	LQPFPQPELPYPQPQ	1
CASSLSGADNSPLHF	LQPFPQPELPYPQPQ	1
CASSVQGITNEKLFF	LQPFPQPELPYPQPQ	1
CASSQVTLPTETRYF	LQPFPQPELPYPQPQ	1
CASSWGQGYQPQHF	LQPFPQPELPYPQPQ	1
CASSPLSFGGGQETQYF	LQPFPQPELPYPQPQ	1
CASSLGETQYF	LLQTGIHVRVSQPSL	1
CASSLGSRAQETQYF	LLQTGIHVRVSQPSL	1
CASSLGQSTQYF	LLQTGIHVRVSQPSL	1
CASSLQGSRRQGQNEQYF	LLQTGIHVRVSQPSL	1
CASSSQGGEGTEAFF	LLQTGIHVRVSQPSL	1
CASSLDGGRDNEAFF	LLQTGIHVRVSQPSL	1
CASSWTGTDYGYTF	LLQTGIHVRVSQPSL	1
CASSSGDQNQPQHF	LLQTGIHVRVSQPSL	1
CASSFGTGVNSPLHF	LLQTGIHVRVSQPSL	1
CASSLRKSSYNEQFF	LLQTGIHVRVSQPSL	1
CASSQGEGVAEQFF	LLQTGIHVRVSQPSL	1
CASSSDRGRNIQYF	LLQTGIHVRVSQPSL	1
CASTPRASGETQYF	LLQTGIHVRVSQPSL	1
CASTGLAGEETQYF	LLQTGIHVRVSQPSL	1
CASSAWTSTGRRYEQYF	LLQTGIHVRVSQPSL	1
CASSLMGASGIDGQFF	LLQTGIHVRVSQPSL	1
CASSSPLAGGGRETQYF	LLQTGIHVRVSQPSL	1
CASRTRGRAYNEQFF	LLQTGIHVRVSQPSL	1
CSIGTGGYNEQFF	LLQTGIHVRVSQPSL	1
CSVEITGGLGESFF	LLQTGIHVRVSQPSL	1
CSVDYTAGTGGTEAFF	LLQTGIHVRVSQPSL	1
CSVVRTDTQYF	LLQTGIHVRVSQPSL	1
CSVGQGTGKQETQYF	LLQTGIHVRVSQPSL	1
CASSLGAGGHNEQFF	LLQTGIHVRVSQPSL	1
CASSRGLAGGNGELFF	LLQTGIHVRVSQPSL	1
CSARDRGVGYEQYF	LLQTGIHVRVSQPSL	1
CSARGLAGATDTQYF	LLQTGIHVRVSQPSL	1
CASSWGQNEQFF	LLQTGIHVRVSQPSL	1
CASKEGRLAANTGELFF	LLQTGIHVRVSQPSL	1
CAIREGPTNEKLFF	LLQTGIHVRVSQPSL	1
CAISERDISSYEQYF	LLQTGIHVRVSQPSL	1
CASGPRLLTSEAFF	LLQTGIHVRVSQPSL	1
CASSLSRSRRNTIYF	LLQTGIHVRVSQPSL	1
CASSLGWGEETQYF	LLQTGIHVRVSQPSL	1
CASSLRYRGRWSNEQFF	LLQTGIHVRVSQPSL	1
CASSLTGTGGNTEAFF	LLQTGIHVRVSQPSL	1
CASSRGTEAFF	LLQTGIHVRVSQPSL	1
CASSFKGQNTEAFF	LLQTGIHVRVSQPSL	1
CASSLEGIGQGIGLGTEAFF	LLQTGIHVRVSQPSL	1
CASSLEGGGGNQPQHF	LLQTGIHVRVSQPSL	1
CASSFSGSHLETQYF	LLQTGIHVRVSQPSL	1
CASSTDRNQPQHF	LLQTGIHVRVSQPSL	1
CASTSGSFTGELFF	LLQTGIHVRVSQPSL	1
CASRGAGTRTDTQYF	LLQTGIHVRVSQPSL	1
CASSLGGEETQYF	LLQTGIHVRVSQPSL	1
CASSPDTSGANVLTF	LLQTGIHVRVSQPSL	1
CSASLDSGTQETQYF	LLQTGIHVRVSQPSL	1
CSASKGQGEAFF	LLQTGIHVRVSQPSL	1
CSARQGAANYGYTF	LLQTGIHVRVSQPSL	1
CSAIPFRPGGLNEQFF	LLQTGIHVRVSQPSL	1
CSARAGGGQETQYF	LLQTGIHVRVSQPSL	1
CASSLAPGGGEAFF	LLQTGIHVRVSQPSL	1
CASSLATSSYEQYF	LLQTGIHVRVSQPSL	1
CASSYIRGGEQYF	LLQTGIHVRVSQPSL	1
CASRQGGSDTQYF	LLQTGIHVRVSQPSL	1
CASSRRVPTSGMSPYEQYF	LLQTGIHVRVSQPSL	1
CASSVAGRTGGHGYTF	LLQTGIHVRVSQPSL	1
CASSFGRGHIEQFF	LLQTGIHVRVSQPSL	1
CASSLRQGLNEQFF	LLQTGIHVRVSQPSL	1
CASSQAGASGRAAVPIF	LLQTGIHVRVSQPSL	1
CAWSETSGKYNEQFF	LLQTGIHVRVSQPSL	1
CAWSEASGFTDTQYF	LLQTGIHVRVSQPSL	1
CAWSRWRQETQYF	LLQTGIHVRVSQPSL	1
CSVGTREGGEQYF	LLQTGIHVRVSQPSL	1
CSLIDNTEAFF	LLQTGIHVRVSQPSL	1
CASSLVGQVNTEAFF	LLQTGIHVRVSQPSL	1
CASSLAANTEAFF	LLQTGIHVRVSQPSL	1
CASSFAPGELFF	LLQTGIHVRVSQPSL	1
CASRPRGGARPYEQYF	LLQTGIHVRVSQPSL	1
CASSFKVDTYTEAFF	LLQTGIHVRVSQPSL	1
CASSLASGNIWYNEQFF	LLQTGIHVRVSQPSL	1
CASSFRETQYF	LLQTGIHVRVSQPSL	1
CASNDRVINEQFF	LLQTGIHVRVSQPSL	1
CASLGNNSPLHF	LLQTGIHVRVSQPSL	1
CASSRDRGPGGYGYTF	LLQTGIHVRVSQPSL	1
CASSEALGGQGEKLFF	LLQTGIHVRVSQPSL	1
CASRDRFYGYTF	LLQTGIHVRVSQPSL	1
CSARQVVIWNTEAFF	LLQTGIHVRVSQPSL	1
CSARVSATAQYF	LLQTGIHVRVSQPSL	1
CSATGTGANYEQYF	LLQTGIHVRVSQPSL	1
CSARDFYSTSGRVSAKNIQYF	LLQTGIHVRVSQPSL	1
CSARPTSGELFF	LLQTGIHVRVSQPSL	1
CSVEGSSRNIQYF	LLQTGIHVRVSQPSL	1
CSARPPTRDTQYF	LLQTGIHVRVSQPSL	1
CSARDPAGANRETQYF	LLQTGIHVRVSQPSL	1
CSAQAGTGGLSEQFF	LLQTGIHVRVSQPSL	1
CSAFVQETQYF	LLQTGIHVRVSQPSL	1
CSAREFGTGNQPQHF	LLQTGIHVRVSQPSL	1
CSAISGGADTQYF	LLQTGIHVRVSQPSL	1
CSAEQFF	LLQTGIHVRVSQPSL	1
CSARDPLINTQYF	LLQTGIHVRVSQPSL	1
CSAGSVLAGSADTQYF	LLQTGIHVRVSQPSL	1
CASSPPISGANVLTF	LLQTGIHVRVSQPSL	1
CASSLDGSPSLAKNIQYF	LLQTGIHVRVSQPSL	1
CASSLYRQGADGYTF	LLQTGIHVRVSQPSL	1
CASSLAPLDSQPQHF	LLQTGIHVRVSQPSL	1
CASSLDGTQGTQYF	LLQTGIHVRVSQPSL	1
CASSPLSGGAEQYF	LLQTGIHVRVSQPSL	1
CASSSLAGGPIVGELFF	LLQTGIHVRVSQPSL	1
CASSSRQGGNQPQHF	LLQTGIHVRVSQPSL	1
CASRFARAGGLGTQYF	LLQTGIHVRVSQPSL	1
CASGSGGGYEQYF	LLQTGIHVRVSQPSL	1
CASRQGENQPQHF	LLQTGIHVRVSQPSL	1
CASISSFRGGSETQYF	LLQTGIHVRVSQPSL	1
CASRPSGANVLTF	LLQTGIHVRVSQPSL	1
CASSLMYEQYF	LLQTGIHVRVSQPSL	1
CASSPFGTGSGYRTEAFF	LLQTGIHVRVSQPSL	1
CASRRDNSYEQYF	LLQTGIHVRVSQPSL	1
CASRKLVNTGELFF	LLQTGIHVRVSQPSL	1
CASSRQGEAFF	LLQTGIHVRVSQPSL	1
CASSAASYNEQFF	LLQTGIHVRVSQPSL	1
CASSPRAGKETQYF	LLQTGIHVRVSQPSL	1
CASRPGQNYEQYF	LLQTGIHVRVSQPSL	1
CASSSPGYGYTF	LLQTGIHVRVSQPSL	1
CASSSIRGNEQFF	LLQTGIHVRVSQPSL	1
CASSSNRGMTQYF	LLQTGIHVRVSQPSL	1
CASSQEGASGETYNEQFF	LLQTGIHVRVSQPSL	1
CASSQEYSPIGIADTQYF	LLQTGIHVRVSQPSL	1
CASSPLAGGADTQYF	LLQTGIHVRVSQPSL	1
CASSQEGNYGYTF	LLQTGIHVRVSQPSL	1
CSVADRGLSGPGYEQYF	LLQTGIHVRVSQPSL	1
CSVGQGGLGANVLTF	LLQTGIHVRVSQPSL	1
CSVARAGGRRETQYF	LLQTGIHVRVSQPSL	1
CASSSRPESSYEQYF	LLQTGIHVRVSQPSL	1
CASSARDRQHEQFF	LLQTGIHVRVSQPSL	1
CASSPQDGFNEQFF	LLQTGIHVRVSQPSL	1
CASSEGQGETQYF	LLQTGIHVRVSQPSL	1
CASSERRGGGVTQYF	LLQTGIHVRVSQPSL	1
CASSTRLAADTQYF	LLQTGIHVRVSQPSL	1
CASTQNRGWYEQYF	LLQTGIHVRVSQPSL	1
CASQNRGKIYGYTF	LLQTGIHVRVSQPSL	1
CASSPPKTRSSGSGANVLTF	LLQTGIHVRVSQPSL	1
CASSPSGSAYEQYF	LLQTGIHVRVSQPSL	1
CASSSIYNEKLFF	LLQTGIHVRVSQPSL	1
CASSLSKGQPQHF	LLQTGIHVRVSQPSL	1
CASSQGYANTEAFF	LLQTGIHVRVSQPSL	1
CASSLFSASGGKNEQFF	LLQTGIHVRVSQPSL	1
CASRETGKTDGYTF	LLQTGIHVRVSQPSL	1
CASSFGAIETQYF	LLQTGIHVRVSQPSL	1
CASIKLPSYEQYF	LLQTGIHVRVSQPSL	1
CASSEGFSYEQYF	LLQTGIHVRVSQPSL	1
CASSPGGADRRIDGYTF	LLQTGIHVRVSQPSL	1
CASSLALGGYNEQFF	LLQTGIHVRVSQPSL	1
CASSLEETQYF	LLQTGIHVRVSQPSL	1
CASSPRTAQETQYF	LLQTGIHVRVSQPSL	1
CATSSLATGELFF	LLQTGIHVRVSQPSL	1
CATSRDVNTGELFF	LLQTGIHVRVSQPSL	1
CASGQSEKLFF	LLQTGIHVRVSQPSL	1
CASSLSGVSDGQFF	LLQTGIHVRVSQPSL	1
CASSLLVGNTEAFF	LLQTGIHVRVSQPSL	1
CASSLNKAPSEQYF	LLQTGIHVRVSQPSL	1
CASSLTTGGNQPQHF	LLQTGIHVRVSQPSL	1
CASKTSGGVNEQFF	LLQTGIHVRVSQPSL	1
CASSRTSGYNEQFF	LLQTGIHVRVSQPSL	1
CASSLMPGQGSYEQYF	LLQTGIHVRVSQPSL	1
CASSLVSGQGQREQYF	LLQTGIHVRVSQPSL	1
CASSLDQETQYF	LLQTGIHVRVSQPSL	1
CSARGGVDSNQPQHF	LLQTGIHVRVSQPSL	1
CSAVRGLANTEAFF	LLQTGIHVRVSQPSL	1
CSASEGQGLNQPQHF	LLQTGIHVRVSQPSL	1
CSTSAAYNEQFF	LLQTGIHVRVSQPSL	1
CSARPPLSAGGKYNEQFF	LLQTGIHVRVSQPSL	1
CSASPYGRERGGDTQYF	LLQTGIHVRVSQPSL	1
CSARRGYEQYF	LLQTGIHVRVSQPSL	1
CASRGGTPYNEQFF	LLQTGIHVRVSQPSL	1
CASRPPGQSLRTQYF	LLQTGIHVRVSQPSL	1
CASSWGGEAFF	LLQTGIHVRVSQPSL	1
CSVEGWTGADNEQFF	LLQTGIHVRVSQPSL	1
CSAGALETQYF	LLQTGIHVRVSQPSL	1
CSAVEGAGGGETQYF	LLQTGIHVRVSQPSL	1
CASSFTSGSYGELFF	LLQTGIHVRVSQPSL	1
CASSLGQGLKETQYF	LLQTGIHVRVSQPSL	1
CASSLYDRGNYGYTF	LLQTGIHVRVSQPSL	1
CASSLGTVDSYEQYF	LLQTGIHVRVSQPSL	1
CASSFTSGSYGELFF	LLQTGIHVRVSQPSL	1
CASSLDAQNSPLHF	LLQTGIHVRVSQPSL	1
CASSRFSGRAADEQFF	LLQTGIHVRVSQPSL	1
CASSPFKRASETQYF	LLQTGIHVRVSQPSL	1
CASSPRTGTYNEQFF	LLQTGIHVRVSQPSL	1
CASSRGTGGRETQYF	LLQTGIHVRVSQPSL	1
CASSGRGSGRKNNEQFF	LLQTGIHVRVSQPSL	1
CASSPEGNYGYTF	LLQTGIHVRVSQPSL	1
CASSPTQSRAGNTIYF	LLQTGIHVRVSQPSL	1
CASSQVSGWAQYF	LLQTGIHVRVSQPSL	1
CSASVSLIYNEQFF	LLQTGIHVRVSQPSL	1
CSAVRGLANTEAFF	LLQTGIHVRVSQPSL	1
CSALGPDTQYF	LLQTGIHVRVSQPSL	1
CSAEVRGLTDTQYF	LLQTGIHVRVSQPSL	1
CSARVFDRGLNSPTEAFF	LLQTGIHVRVSQPSL	1
CSAVRGGGNTEAFF	LLQTGIHVRVSQPSL	1
CSAPPPGQGVYTDTQYF	LLQTGIHVRVSQPSL	1
CSASLDSGTQETQYF	LLQTGIHVRVSQPSL	1
CSARENRVGETQYF	LLQTGIHVRVSQPSL	1
CSATPGQGYEQYF	LLQTGIHVRVSQPSL	1
CSAWSSYEQYF	LLQTGIHVRVSQPSL	1
CSATGGGPYEQYF	LLQTGIHVRVSQPSL	1
CASSSYLRLSADTQYF	LLQTGIHVRVSQPSL	1
CASSLGSQGPYNEQFF	LLQTGIHVRVSQPSL	1
CASSGRGTEAFF	LLQTGIHVRVSQPSL	1
CASSLYSVNTEAFF	LLQTGIHVRVSQPSL	1
CASSLRGGFDNSPLHF	LLQTGIHVRVSQPSL	1
CASSAATSGSMINEQFF	LLQTGIHVRVSQPSL	1
CASSLGVETGNAFF	LLQTGIHVRVSQPSL	1
CASSYDRNQPQHF	LLQTGIHVRVSQPSL	1
CASRLSGANVLTF	LLQTGIHVRVSQPSL	1
CASSLGQSGANVLTF	LLQTGIHVRVSQPSL	1
CASSLFPRGGARSPLHF	LLQTGIHVRVSQPSL	1
CASSWTSFDEQYF	LLQTGIHVRVSQPSL	1
CASSFTGREAYGYTF	LLQTGIHVRVSQPSL	1
CASTPSRGHPNTGELFF	LLQTGIHVRVSQPSL	1
CASRWTSGNTQYF	LLQTGIHVRVSQPSL	1
CASRLRLGAYNEQFF	LLQTGIHVRVSQPSL	1
CASSLTEPGGTDTQYF	LLQTGIHVRVSQPSL	1
CASSPASTDTQYF	LLQTGIHVRVSQPSL	1
CASTRTVEGGEQYF	LLQTGIHVRVSQPSL	1
CASGPTPYNEQFF	LLQTGIHVRVSQPSL	1
CASSSGYSGDTQYF	LLQTGIHVRVSQPSL	1
CASSTTWDRVFEKLFF	LLQTGIHVRVSQPSL	1
CASSYVTGGVPVEQYF	LLQTGIHVRVSQPSL	1
CASSYSTGSNQPQHF	LLQTGIHVRVSQPSL	1
CASSTRGRSNEKLFF	LLQTGIHVRVSQPSL	1
CASSPRDSQTLHF	LLQTGIHVRVSQPSL	1
CASSDRAQPQHF	LLQTGIHVRVSQPSL	1
CASSLVQGRGQYF	LLQTGIHVRVSQPSL	1
CASSQDAGISYNEQFF	LLQTGIHVRVSQPSL	1
CSAQTSGSGEQYF	LLQTGIHVRVSQPSL	1
CSVVPEQFF	LLQTGIHVRVSQPSL	1
CAAKDQNLTNYGYTF	LLQTGIHVRVSQPSL	1
CAISSGWGNNEQFF	LLQTGIHVRVSQPSL	1
CAIRGTSGRDSEQFF	LLQTGIHVRVSQPSL	1
CASSVPTGRGYTF	LLQTGIHVRVSQPSL	1
CASSPRGLGNTIYF	LLQTGIHVRVSQPSL	1
CASSEGRNEQFF	LLQTGIHVRVSQPSL	1
CASAQETQYF	LLQTGIHVRVSQPSL	1
CASNDWDTGELFF	LLQTGIHVRVSQPSL	1
CASSFDGNSPLHF	LLQTGIHVRVSQPSL	1
CASRGQGSSNEQFF	LLQTGIHVRVSQPSL	1
CASSIGQRNYNEQFF	LLQTGIHVRVSQPSL	1
CASSSTGISSYEQYF	LLQTGIHVRVSQPSL	1
CASSSLHGVDEQFF	LLQTGIHVRVSQPSL	1
CASSLEGTYSNTGELFF	LLQTGIHVRVSQPSL	1
CASSWQRPINEQFF	LLQTGIHVRVSQPSL	1
CASSLGTGGDEQYF	LLQTGIHVRVSQPSL	1
CASSRRTPRRETQYF	LLQTGIHVRVSQPSL	1
CASSTLDEQFF	LLQTGIHVRVSQPSL	1
CASSVEGISGSQFF	LLQTGIHVRVSQPSL	1
CASSPSRGRSHEQYF	LLQTGIHVRVSQPSL	1
CATSDLQGTGELFF	LLQTGIHVRVSQPSL	1
CAWSLQGRRDRGRNEQFF	LLQTGIHVRVSQPSL	1
CSARGTSGGSIGELFF	LLQTGIHVRVSQPSL	1
CSAGWLGSLRTEAFF	LLQTGIHVRVSQPSL	1
CSASGREGHPDTQYF	LLQTGIHVRVSQPSL	1
CSASDREGHPDTQYF	LLQTGIHVRVSQPSL	1
CSASNPIYEQYF	LLQTGIHVRVSQPSL	1
CSAEPIFSGYNEQFF	LLQTGIHVRVSQPSL	1
CSATLNNEQFF	LLQTGIHVRVSQPSL	1
CSASYPRTGNRVNTEAFF	LLQTGIHVRVSQPSL	1
CSAHPRGVGELFF	LLQTGIHVRVSQPSL	1
CSDSNPIDEQYF	LLQTGIHVRVSQPSL	1
CSASPGANGLDQPQHF	LLQTGIHVRVSQPSL	1
CSARDPGDDKPQHF	LLQTGIHVRVSQPSL	1
CSARALGRPQETQYF	LLQTGIHVRVSQPSL	1
CASSLDGTQGTQYF	LLQTGIHVRVSQPSL	1
CASSPYNEQFF	LLQTGIHVRVSQPSL	1
CASSLASYGYTF	LLQTGIHVRVSQPSL	1
CASSLVTGDFEKLFF	LLQTGIHVRVSQPSL	1
CASSRYLSGGTDTQYF	LLQTGIHVRVSQPSL	1
CASSLRAGVDVPEQFF	LLQTGIHVRVSQPSL	1
CASSFTGGNIQYF	LLQTGIHVRVSQPSL	1
CASSPLGGPRDIQYF	LLQTGIHVRVSQPSL	1
CASSYSGGGSYNEQFF	LLQTGIHVRVSQPSL	1
CASSYSWDRVLEQYF	LLQTGIHVRVSQPSL	1
CASRRDGTGTYEQYF	LLQTGIHVRVSQPSL	1
CASSYSPHRVVGQETYEQYF	LLQTGIHVRVSQPSL	1
CASSLNPSAGIAWSEQFF	LLQTGIHVRVSQPSL	1
CASSSGGHRTGELFF	LLQTGIHVRVSQPSL	1
CASSLWADQPQHF	LLQTGIHVRVSQPSL	1
CASGWTSGSRDTQYF	LLQTGIHVRVSQPSL	1
CASSGRTGPGEQYF	LLQTGIHVRVSQPSL	1
CASSKAGHYEQYF	LLQTGIHVRVSQPSL	1
CSAGLAGGHEQYF	LLQTGIHVRVSQPSL	1
CSVDYGGNTEAFF	LLQTGIHVRVSQPSL	1
CSVVRGAGELFF	LLQTGIHVRVSQPSL	1
CASSESYGTETQYF	LLQTGIHVRVSQPSL	1
CASSRDRAGYGYTF	LLQTGIHVRVSQPSL	1
CASSLAPSRPQHF	LLQTGIHVRVSQPSL	1
CASRGLAGDEQYF	LLQTGIHVRVSQPSL	1
CAISPGQDTDTQYF	LLQTGIHVRVSQPSL	1
CASSQDSGTRANNEQFF	LLQTGIHVRVSQPSL	1
CASSQEGGQGTFQPQHF	LLQTGIHVRVSQPSL	1
CASSQLSSVNNEQFF	LLQTGIHVRVSQPSL	1
CASSQEEGSGANVLTF	LLQTGIHVRVSQPSL	1
CASYSGLASTDTQYF	LLQTGIHVRVSQPSL	1
CASSSGLPNTGELFF	LLQTGIHVRVSQPSL	1
CASSRTGGGVNTGELFF	LLQTGIHVRVSQPSL	1
CASSPYWGQVNEQYF	LLQTGIHVRVSQPSL	1
CASSPEGGSYEQYF	LLQTGIHVRVSQPSL	1
CASRLGQGAVSPLHF	LLQTGIHVRVSQPSL	1
CASSQGTGDQETQYF	LLQTGIHVRVSQPSL	1
CASSVGSGGLYQPQHF	LLQTGIHVRVSQPSL	1
CASSERSNEQFF	LLQTGIHVRVSQPSL	1
CASSSFGYNEQFF	LLQTGIHVRVSQPSL	1
CASSFISGGADTGELFF	LLQTGIHVRVSQPSL	1
CASSRDTQETQYF	LLQTGIHVRVSQPSL	1
CASSETSGFYNEQFF	LLQTGIHVRVSQPSL	1
CSAVFTDTQYF	EHPTFTSQYRIQGKL	1
CSAPLQGNNSPLHF	EHPTFTSQYRIQGKL	1
CSARSRGDTDTQYF	EHPTFTSQYRIQGKL	1
CSARAQGPSQETQYF	EHPTFTSQYRIQGKL	1
CSARDYRGTYEQYF	EHPTFTSQYRIQGKL	1
CSALTSDIRTEAFF	EHPTFTSQYRIQGKL	1
CSATDRASNQPQHF	EHPTFTSQYRIQGKL	1
CSAVAGGTQADTQYF	EHPTFTSQYRIQGKL	1
CSAPVGLGAADTQYF	EHPTFTSQYRIQGKL	1
CSASPGPINNEQFF	EHPTFTSQYRIQGKL	1
CSARAAYIGGAREQYF	EHPTFTSQYRIQGKL	1
CASSSTGYYGYTF	EHPTFTSQYRIQGKL	1
CASSLIQGNNEQFF	EHPTFTSQYRIQGKL	1
CASSLASGLVGSSPLHF	EHPTFTSQYRIQGKL	1
CASSLASGEQYF	EHPTFTSQYRIQGKL	1
CASSLMSSYNSPLHF	EHPTFTSQYRIQGKL	1
CSVRPTRNEQFF	EHPTFTSQYRIQGKL	1
CASSPTGTGGIGIYGYTF	EHPTFTSQYRIQGKL	1
CASSFEGGTQETQYF	EHPTFTSQYRIQGKL	1
CASSLGETGYEQYF	EHPTFTSQYRIQGKL	1
CASSFSSGANEQFF	EHPTFTSQYRIQGKL	1
CASSAGQGGSYEQYF	EHPTFTSQYRIQGKL	1
CASSQERARHKLFF	EHPTFTSQYRIQGKL	1
CASSQDQWGLAGYQETQYF	EHPTFTSQYRIQGKL	1
CASSYGGGTEAFF	EHPTFTSQYRIQGKL	1
CASSPQGGELFF	EHPTFTSQYRIQGKL	1
CASTLKGSRETQYF	EHPTFTSQYRIQGKL	1
CASSLDLFSGNTIYF	EHPTFTSQYRIQGKL	1
CASSRDRGSTDTQYF	EHPTFTSQYRIQGKL	1
CASSVGQGNQPQHF	EHPTFTSQYRIQGKL	1
CASSVGPGPGDTEAFF	PKYVKQNTLKLAT	1
CASSLISEPNTEAFF	PKYVKQNTLKLAT	1
CASTQGVLTYEQYF	PKYVKQNTLKLAT	1
CASSGVPEQTPSYEQYF	PKYVKQNTLKLAT	1
CASTPSWETEAFF	PKYVKQNTLKLAT	1
CASSPYRAQNTEAFF	PKYVKQNTLKLAT	1
CASSVVPEWEGELFF	PKYVKQNTLKLAT	1
CASSPLTGGQTDTQYF	PKYVKQNTLKLAT	1
CASSSPSLADNNEQFF	PKYVKQNTLKLAT	1
CASRTGTHTDTQYF	PKYVKQNTLKLAT	1
CASSLSPELETQYF	PKYVKQNTLKLAT	1
CASSVGQGKAFF	PKYVKQNTLKLAT	1
CASSLGQGEQFF	PKYVKQNTLKLAT	1
CASSLSQGDQPQHF	PKYVKQNTLKLAT	1
CASSVAPSPSETEAFF	PKYVKQNTLKLAT	1
CASSVAPSGSESPLHF	PKYVKQNTLKLAT	1
CASSTGFSEQFF	PKYVKQNTLKLAT	1
CASSAGFSEQFF	PKYVKQNTLKLAT	1
CSARGQAIYGYTF	PKYVKQNTLKLAT	1
CASSPGQIYGYTF	PKYVKQNTLKLAT	1
CASIKGGQDYSPLHF	PKYVKQNTLKLAT	1
CASSPGGGDTYNEQFF	PKYVKQNTLKLAT	1
CASSDSGTYNEQFF	PKYVKQNTLKLAT	1
CASSTIGLDTGELFF	PKYVKQNTLKLAT	1
CASSLAPELDTQYF	PKYVKQNTLKLAT	1
CASSLVPELGEQYF	PKYVKQNTLKLAT	1
CASSEAWTSGKNEQFF	PKYVKQNTLKLAT	1
CASSSDGTGEKLFF	PKYVKQNTLKLAT	1
CASSVLTDNGYTF	PKYVKQNTLKLAT	1
CASSREGTVNHGGYTF	PKYVKQNTLKLAT	1
CASTGSSYEQYF	PKYVKQNTLKLAT	1
CASSSPWETQYF	PKYVKQNTLKLAT	1
CAWDRLARFQETQYF	PKYVKQNTLKLAT	1
CASSVTPGGTEAFF	PKYVKQNTLKLAT	1
CASSGTGEPTNEKLFF	PKYVKQNTLKLAT	1
CSADSGTSTDTQYF	PKYVKQNTLKLAT	1
CASSLNPELNYGYTF	PKYVKQNTLKLAT	1
CASGATGHHNSPLHF	PKYVKQNTLKLAT	1
CASRDSGTRNEQFF	PKYVKQNTLKLAT	1
CASGFGSGSLTDTQYF	PKYVKQNTLKLAT	1
CASSTTQGFYEQYF	PKYVKQNTLKLAT	1
CASSLGLAGDQETQYF	PKYVKQNTLKLAT	1
CASNNGLAHTPEYF	PKYVKQNTLKLAT	1
CASSQPAGPSTDTQYF	PKYVKQNTLKLAT	1
CASSSYLWTGNLSPLHF	PKYVKQNTLKLAT	1
CASSLGQNEQYF	PKYVKQNTLKLAT	1
CASSLGQGEQYF	PKYVKQNTLKLAT	1
CASSFLGQFSYEQYF	PKYVKQNTLKLAT	1
CASSLDSDHEQYF	PKYVKQNTLKLAT	1
CASSLGGEVSGQGNQPQHF	PKYVKQNTLKLAT	1
CASSDARTGDIGQYF	PKYVKQNTLKLAT	1
CASSDPTGTGANVLTF	PKYVKQNTLKLAT	1
CASSDAGTGDYEQYF	PKYVKQNTLKLAT	1
CASGPLGGDNQPQHF	PKYVKQNTLKLAT	1
CASSEIAGGLGFF	PKYVKQNTLKLAT	1
CATSDTGTSVGGQYF	PKYVKQNTLKLAT	1
CASSSSESGSYNEQFF	PKYVKQNTLKLAT	1
CASVPGLSYEQYF	PKYVKQNTLKLAT	1
CASSVTPGHTEAFF	PKYVKQNTLKLAT	1
CASSVAGGETEAFF	PKYVKQNTLKLAT	1
CASSVAPSANTGELFF	PKYVKQNTLKLAT	1
CASSFSPGPPEGELFF	PKYVKQNTLKLAT	1
CASSLEEQRAFF	PKYVKQNTLKLAT	1
CASNSGYMNFF	PKYVKQNTLKLAT	1
CASSEDRRGSYEQYF	PKYVKQNTLKLAT	1
CASSDAGTGDYEQYF	PKYVKQNTLKLAT	1
CASSPVQGASGNTIYF	PKYVKQNTLKLAT	1
CASSYVDGSSYEQYF	PKYVKQNTLKLAT	1
CAWSPLEIAGTDTQYF	PKYVKQNTLKLAT	1
CASSVAPGSEGEAFF	PKYVKQNTLKLAT	1
CSAGGWDRVNQPQHF	PKYVKQNTLKLAT	1
CASSESQTGDYEQYF	PKYVKQNTLKLAT	1
CATSDSTSGGTDTQYF	PKYVKQNTLKLAT	1
CASSFSAEATGELFF	PKYVKQNTLKLAT	1
CASSRLEARELFF	PKYVKQNTLKLAT	1
CASSLTNRGLNMNTEAFF	PKYVKQNTLKLAT	1
CASSLTGGSETQYF	PKYVKQNTLKLAT	1
CASSVPGEESGRGNTEAFF	PKYVKQNTLKLAT	1
CASSLGRGEQYF	PKYVKQNTLKLAT	1
CASSRGTENEKLFF	PKYVKQNTLKLAT	1
CASSGSGPLRGYTF	PKYVKQNTLKLAT	1
CASSPAGPGNTIYF	PKYVKQNTLKLAT	1
CASSDPGHQNSPLHF	PKYVKQNTLKLAT	1
CASSFSAEATGELFF	PKYVKQNTLKLAT	1
CASSYEGTEAFF	PKYVKQNTLKLAT	1
CASSYDLEPTNEKLFF	PKYVKQNTLKLAT	1
CASSYSGSLGEKLFF	PKYVKQNTLKLAT	1
CASIEQGALTNEQFF	PKYVKQNTLKLAT	1
CASTLDRDGTQYF	PKYVKQNTLKLAT	1
CASSGSPGQGAEYF	PKYVKQNTLKLAT	1
CATSAGGAEPTDTQYF	PKYVKQNTLKLAT	1
CASSWRGGIQGVAGELFF	PKYVKQNTLKLAT	1
CASTQRDRDTGELFF	TFEYVSQPFLMDLE	1
CASSPWLAGSSTDTQYF	TFEYVSQPFLMDLE	1
CASSPRDRGTDTQYF	TFEYVSQPFLMDLE	1
CASSYSVAGGPNTGELFF	TFEYVSQPFLMDLE	1
CASSYRGAPVHGYTF	TFEYVSQPFLMDLE	1
CASTPRQGFGYTF	TFEYVSQPFLMDLE	1
CASTNRPGQGANYGYTF	TFEYVSQPFLMDLE	1
CASSSTGSPYGYTF	TFEYVSQPFLMDLE	1
CASSRSLEAFF	TFEYVSQPFLMDLE	1
CASSRRQGIGGYTF	TFEYVSQPFLMDLE	1
CASSRSGNYGYTF	TFEYVSQPFLMDLE	1
CASGLKGTGELFF	TFEYVSQPFLMDLE	1
CAIPQGYGYTF	TFEYVSQPFLMDLE	1
CASRNRSPKHGYTF	TFEYVSQPFLMDLE	1
CASSLNRAGDTGELFF	TFEYVSQPFLMDLE	1
CASTPGRQGARGYTF	TFEYVSQPFLMDLE	1
CASSYGRVRTGELFF	TFEYVSQPFLMDLE	1
CASSVAVDRGYGYTF	TFEYVSQPFLMDLE	1
CASSPARRANTGELFF	TFEYVSQPFLMDLE	1
CASSLRRTGLQGYTF	TFEYVSQPFLMDLE	1
CASSPRPVTGLAEAFF	TFEYVSQPFLMDLE	1
CASRPDRVDTEAFF	TFEYVSQPFLMDLE	1
CASSPRGQGEGYTF	TFEYVSQPFLMDLE	1
CASSLARNANTGELFF	TFEYVSQPFLMDLE	1
CASSSRGGEMGGYTF	TFEYVSQPFLMDLE	1
CASSARGAIGYTF	TFEYVSQPFLMDLE	1
CASKGLGSTDTQYF	TFEYVSQPFLMDLE	1
CASSVDRGSLRGYTF	TFEYVSQPFLMDLE	1
CATSLRGADGYTF	TFEYVSQPFLMDLE	1
CATSNRGALGYTF	TFEYVSQPFLMDLE	1
CASSPRGANGYTF	TFEYVSQPFLMDLE	1
CASRPRDQRYTF	TFEYVSQPFLMDLE	1
CASIPRLHLFTEAFF	TFEYVSQPFLMDLE	1
CASSYRGGGTGELFF	TFEYVSQPFLMDLE	1
CASAAGIEAFF	TFEYVSQPFLMDLE	1
CASSPRGGNGYTF	TFEYVSQPFLMDLE	1
CASSQGGLGYTF	TFEYVSQPFLMDLE	1
CASSDSFGYTF	TFEYVSQPFLMDLE	1
CASSYSPGSVYGYTF	TFEYVSQPFLMDLE	1
CASSATFGYTF	TFEYVSQPFLMDLE	1
CASSLRGDAGYTF	TFEYVSQPFLMDLE	1
CASGSSLGQYF	TFEYVSQPFLMDLE	1
CASSPRGGNGYTF	TFEYVSQPFLMDLE	1
CASRPDRGLGEQFF	TFEYVSQPFLMDLE	1
CASTRGGLGYTF	TFEYVSQPFLMDLE	1
CASSPRGRLNTGELFF	TFEYVSQPFLMDLE	1
CASRNRAGSPLHF	TFEYVSQPFLMDLE	1
CAWARRAGRASPTYGYTF	TFEYVSQPFLMDLE	1
CASSLERGQLYGYTF	TFEYVSQPFLMDLE	1
CASSYRGGTPLHF	TFEYVSQPFLMDLE	1
CASSPRPGAYSGYTF	TFEYVSQPFLMDLE	1
CASSFRGGDGYTF	TFEYVSQPFLMDLE	1
CASSNRQRNSLYGYTF	TFEYVSQPFLMDLE	1
CASSPSGRAPDTQYF	TFEYVSQPFLMDLE	1
CASSQSFGYTF	TFEYVSQPFLMDLE	1
CASSLRGSGGYTF	TFEYVSQPFLMDLE	1
CASSVRQSNTGELFF	TFEYVSQPFLMDLE	1
CASSVGGLGYTF	TFEYVSQPFLMDLE	1
CASSFRGGSLYGYTF	TFEYVSQPFLMDLE	1
CASSLRTRLNTGELFF	TFEYVSQPFLMDLE	1
CASSVRGLANTGELFF	TFEYVSQPFLMDLE	1
CASSPRGTEAFF	TFEYVSQPFLMDLE	1
CASSPRTSGTGEQYF	TFEYVSQPFLMDLE	1
CASTLRRTVGTGELFF	TFEYVSQPFLMDLE	1
CASATPFGYTF	TFEYVSQPFLMDLE	1
CASSLTGGKGYTF	TFEYVSQPFLMDLE	1
CASSYTSGSLSGLFF	TFEYVSQPFLMDLE	1
CASSTRTNLYGYTF	TFEYVSQPFLMDLE	1
CASSPSGLLSLYF	TFEYVSQPFLMDLE	1
CASSQRGAIGYTF	TFEYVSQPFLMDLE	1
CASSSGAPYGYTF	TFEYVSQPFLMDLE	1
CSARTGIGYTF	TFEYVSQPFLMDLE	1
CASSSGGLGYTF	TFEYVSQPFLMDLE	1
CASSFRGADGYTF	TFEYVSQPFLMDLE	1
CASSYARRANTGELFF	TFEYVSQPFLMDLE	1
CASSSSRAANTGELFF	TFEYVSQPFLMDLE	1
CASSFSGSYGYTF	TFEYVSQPFLMDLE	1
CASSPSGRAPDTQYF	TFEYVSQPFLMDLE	1
CASSQSRGPVYGYTF	TFEYVSQPFLMDLE	1
CAGEAGGLGQYF	TFEYVSQPFLMDLE	1
CASSLKTGGWGYTF	TFEYVSQPFLMDLE	1
CSGRGRGPETQYF	TFEYVSQPFLMDLE	1
CASGGAWGYTF	TFEYVSQPFLMDLE	1
CASSFSRTGYFSGNTIYF	TFEYVSQPFLMDLE	1
CASSGTRGALGYTF	TFEYVSQPFLMDLE	1
CASTTRRGNTGELFF	TFEYVSQPFLMDLE	1
CASSLRGDYGYTF	TFEYVSQPFLMDLE	1
CASSYRGAYGYTF	TFEYVSQPFLMDLE	1
CASSFTGGSPRGYTF	TFEYVSQPFLMDLE	1
CASNPRGGDGYTF	TFEYVSQPFLMDLE	1
CASSSSGSLKGYTF	TFEYVSQPFLMDLE	1
CASSPRKNTGTGGNGYTF	TFEYVSQPFLMDLE	1
CASSHGVGYTF	TFEYVSQPFLMDLE	1
CASSPRTGALNGYTF	TFEYVSQPFLMDLE	1
CASSPRRDSPTGYTF	TFEYVSQPFLMDLE	1
CASYFGRGGHGYTF	TFEYVSQPFLMDLE	1
CASSPRGGHGYTF	TFEYVSQPFLMDLE	1
CASSQGGLAWHF	TFEYVSQPFLMDLE	1
CASSPARGQIYGYTF	TFEYVSQPFLMDLE	1
CASSFSRGSLGGYTF	TFEYVSQPFLMDLE	1
CASSYGGGPLRGYTF	TFEYVSQPFLMDLE	1
CASSYRGGGNTIYF	TFEYVSQPFLMDLE	1
CASSSRGANGYTF	TFEYVSQPFLMDLE	1
CASSTNPGTASWGYTF	TFEYVSQPFLMDLE	1
CASRDRAPETQYF	TFEYVSQPFLMDLE	1
CASSPRGSFGYTF	TFEYVSQPFLMDLE	1
CASSALRGQIYGYTF	TFEYVSQPFLMDLE	1
CAWKSRRQNLYGYTF	TFEYVSQPFLMDLE	1
CASSYRGDYGYTF	TFEYVSQPFLMDLE	1
CASSISFGYTF	TFEYVSQPFLMDLE	1
CASSYRQGSLHGYTF	TFEYVSQPFLMDLE	1
CASSLRGDYGYTF	TFEYVSQPFLMDLE	1
CASSFTPGTPYGYTF	TFEYVSQPFLMDLE	1
CASSERGQGGYTF	TFEYVSQPFLMDLE	1
CASSGRSGGFGYTF	TFEYVSQPFLMDLE	1
CASSSRGADGYTF	TFEYVSQPFLMDLE	1
CASSFTPGTPYGYTF	TFEYVSQPFLMDLE	1
CASSGRQGAVDGYTF	TFEYVSQPFLMDLE	1
CASTNRGRTEAFF	TFEYVSQPFLMDLE	1
CASHSGTSKAFF	TFEYVSQPFLMDLE	1
CASSPRFPPGTGELFF	TFEYVSQPFLMDLE	1
CASSYSPGQLYGYTF	TFEYVSQPFLMDLE	1
CASSLRGADGYTF	TFEYVSQPFLMDLE	1
CASTPRQGSLGQFF	TFEYVSQPFLMDLE	1
CASSLRGAHGYTF	TFEYVSQPFLMDLE	1
CASIYVLGSTYGYTF	TFEYVSQPFLMDLE	1
CASSPRTSGLGEQFF	TFEYVSQPFLMDLE	1
CASSHRKGALEAFF	TFEYVSQPFLMDLE	1
CASSVPGRNYEQYF	TFEYVSQPFLMDLE	1
CASSQRARGQETQYF	TFEYVSQPFLMDLE	1
CASSYSRGTVYGYTF	TFEYVSQPFLMDLE	1
CASSSSPGRIYGYTF	TFEYVSQPFLMDLE	1
CASSPSGGPTLRYGYTF	TFEYVSQPFLMDLE	1
CASSYSKGSLAQHF	TFEYVSQPFLMDLE	1
CASSLRPGTLYGYTF	TFEYVSQPFLMDLE	1
CASSASVGYTF	TFEYVSQPFLMDLE	1
CASSYRAPSNTGELFF	TFEYVSQPFLMDLE	1
CASSYSTGSLGYTF	TFEYVSQPFLMDLE	1
CASSERGALGAFF	TFEYVSQPFLMDLE	1
CASSARQGADLSGYTF	TFEYVSQPFLMDLE	1
CSAPRRTMNTEAFF	TFEYVSQPFLMDLE	1
CASSARGRVNTGELFF	TFEYVSQPFLMDLE	1
CAIPGLTTLHGYTF	TFEYVSQPFLMDLE	1
CASSQIRGATNEKLFF	TFEYVSQPFLMDLE	1
CASSYSAGVIYGYTF	TFEYVSQPFLMDLE	1
CASSPRQGANTGELFF	TFEYVSQPFLMDLE	1
CASSYSLGQPQHF	TFEYVSQPFLMDLE	1
CASSESPSGQETQYF	TFEYVSQPFLMDLE	1
CAISESFGYTF	TFEYVSQPFLMDLE	1
CASSERGALGAFF	TFEYVSQPFLMDLE	1
CASSYRGSDGYTF	TFEYVSQPFLMDLE	1
CASSQRGAVGYTF	TFEYVSQPFLMDLE	1
CASSSKPTGYSNQPQHF	TFEYVSQPFLMDLE	1
CASSYTRDGLVGQYF	TFEYVSQPFLMDLE	1
CASSLARVGNVYGYTF	TFEYVSQPFLMDLE	1
CASSPRSSANTGELFF	TFEYVSQPFLMDLE	1
CASSLRGALGAFF	TFEYVSQPFLMDLE	1
CASSPRRGHLEAFF	TFEYVSQPFLMDLE	1
CASSYSRISNYGYTF	TFEYVSQPFLMDLE	1
CSARGLAGDTQYF	TFEYVSQPFLMDLE	1
CASSSRAGGNSPLHF	TFEYVSQPFLMDLE	1
CASSPQFGLAGELFF	TFEYVSQPFLMDLE	1
CASSSRGPPNTGELFF	TFEYVSQPFLMDLE	1
CASSVTGGWEQYF	TFEYVSQPFLMDLE	1
CSVKTRDGSTEAFF	TFEYVSQPFLMDLE	1
CASSSYRGAYNEQFF	TFEYVSQPFLMDLE	1
CASRRWTSGKGTDTQYF	TFEYVSQPFLMDLE	1
CASSYSPGQLYGYTF	TFEYVSQPFLMDLE	1
CAWAKSFGYTF	TFEYVSQPFLMDLE	1
CASSPRQASFGANVLTF	TFEYVSQPFLMDLE	1
CAIGGTIGYTF	TFEYVSQPFLMDLE	1
CASTRGALTNTGELFF	TFEYVSQPFLMDLE	1
CASSARGSGYTF	TFEYVSQPFLMDLE	1
CASSRRGLNTGELFF	TFEYVSQPFLMDLE	1
CASRDHNTQYF	TFEYVSQPFLMDLE	1
CASSDSFKAFF	TFEYVSQPFLMDLE	1
CASSFRGPPGTGELFF	TFEYVSQPFLMDLE	1
CASSRRSLANTGELFF	TFEYVSQPFLMDLE	1
CASSSRRGHGYTF	TFEYVSQPFLMDLE	1
CASSQGVGYTF	TFEYVSQPFLMDLE	1
CASSGRARSYEQYF	TFEYVSQPFLMDLE	1
CASSPSTGTLYGYTF	TFEYVSQPFLMDLE	1
CASSLTRGTASLYGYTF	TFEYVSQPFLMDLE	1
CASSFRGSNGYTF	TFEYVSQPFLMDLE	1
CASSFRGDYGYTF	TFEYVSQPFLMDLE	1
CASSRGRGGPNTGELFF	TFEYVSQPFLMDLE	1
CASSSRGTGTHGYTF	TFEYVSQPFLMDLE	1
CASSLRGSGLEQYF	TFEYVSQPFLMDLE	1
CASQRWTSGRGTDTQYF	TFEYVSQPFLMDLE	1
CASSVQRIPNTGELFF	TFEYVSQPFLMDLE	1
CASRPRGGSGAFF	TFEYVSQPFLMDLE	1
CASSSRDRGTYEQYF	TFEYVSQPFLMDLE	1
CASNLRRAPNTGELFF	TFEYVSQPFLMDLE	1
CASSYRGTEAFF	TFEYVSQPFLMDLE	1
CASSPRTAPEGYTF	TFEYVSQPFLMDLE	1
CASSYEGIRTGELFF	TFEYVSQPFLMDLE	1
CASSPRGLAPGETQYF	TFEYVSQPFLMDLE	1
CASSVTGGNGYTF	TFEYVSQPFLMDLE	1
CASSYRGDPANYGYTF	TFEYVSQPFLMDLE	1
CASIYRTGGIYGYTF	TFEYVSQPFLMDLE	1
CASTTRAGSFEQYF	TFEYVSQPFLMDLE	1
CASSYSQGAFGYTF	TFEYVSQPFLMDLE	1
CASSSRSGSLYGYTF	TFEYVSQPFLMDLE	1
CASGPGSGLEAFF	TFEYVSQPFLMDLE	1
CASSLRGALGYTF	TFEYVSQPFLMDLE	1
CASSLRGALGYTF	TFEYVSQPFLMDLE	1
CASRPRQGSYNEQFF	TFEYVSQPFLMDLE	1
CASNQGGLRAFF	TFEYVSQPFLMDLE	1
CASSRRSGVNTGELFF	TFEYVSQPFLMDLE	1
CASSTRTGALNGYTF	TFEYVSQPFLMDLE	1
CASSLTGGHGYTF	TFEYVSQPFLMDLE	1
CASSLRKGTLGYTF	TFEYVSQPFLMDLE	1
CASSFRGGTASLF	TFEYVSQPFLMDLE	1
CASSRWTSGGETNIQYF	TFEYVSQPFLMDLE	1
CASSTQGVVRGYTF	TFEYVSQPFLMDLE	1
CASSPARTANTGELFF	TFEYVSQPFLMDLE	1
CASSYRGGGTGELFF	TFEYVSQPFLMDLE	1
CASSYSQGSLYGYTF	TFEYVSQPFLMDLE	1
CASSLKLFTGVNEQFF	TFEYVSQPFLMDLE	1
CASSSSRQTVYGYTF	TFEYVSQPFLMDLE	1
CASSPRGRLNTGELFF	TFEYVSQPFLMDLE	1
CASSPRGGEGYTF	TFEYVSQPFLMDLE	1
CASSPEYGVRGYTF	TFEYVSQPFLMDLE	1
CASNAGGFGYTF	TFEYVSQPFLMDLE	1
CSASPRGTQYF	TFEYVSQPFLMDLE	1
CSALGPRRDTQYF	TFEYVSQPFLMDLE	1
CASIGRPGALGGYTF	TFEYVSQPFLMDLE	1
CASSARQGALGGYTF	TFEYVSQPFLMDLE	1
CASSPRGDYYGYTF	TFEYVSQPFLMDLE	1
CASSPNGRSPETQYF	TFEYVSQPFLMDLE	1
CASSFTGGNGYTF	TFEYVSQPFLMDLE	1
CASSGGSFGYTF	TFEYVSQPFLMDLE	1
CASSLRGDTQYF	TFEYVSQPFLMDLE	1
CASSLRSGGFGYTF	TFEYVSQPFLMDLE	1
CASSRRGGIWSYEQYF	TFEYVSQPFLMDLE	1
CASSSTTGDLRGYTF	TFEYVSQPFLMDLE	1
CASSLRQRANTGELFF	TFEYVSQPFLMDLE	1
CASSYSRTSGGPNTGELFF	TFEYVSQPFLMDLE	1
CASSQTGGSLGYTF	TFEYVSQPFLMDLE	1
CASGSGSVAGPNTGELFF	TFEYVSQPFLMDLE	1
CASTLRGRANTGELFF	TFEYVSQPFLMDLE	1
CASSYRGDYGYTF	TFEYVSQPFLMDLE	1
CASSVRERAGANVLTF	TFEYVSQPFLMDLE	1
CASTRPLSDSLGEQYF	TFEYVSQPFLMDLE	1
CASSVRERAGANVLTF	TFEYVSQPFLMDLE	1
CASRGTSGSLEQFF	TFEYVSQPFLMDLE	1
CASSPRGQGASGELFF	TFEYVSQPFLMDLE	1
CASSVRERAGANVLTF	TFEYVSQPFLMDLE	1
CASSARGRDPGTQYF	TFEYVSQPFLMDLE	1
CASSYRGGGGYTF	TFEYVSQPFLMDLE	1
CATKPTELNTGELFF	TFEYVSQPFLMDLE	1
CASSQRRPGGDPYGYTF	TFEYVSQPFLMDLE	1
CASRPRQGSYNEQFF	TFEYVSQPFLMDLE	1
CASRGQAGILEAFF	TFEYVSQPFLMDLE	1
CASSFRTSGDGTDTQYF	TFEYVSQPFLMDLE	1
CASSPARRANTGELFF	TFEYVSQPFLMDLE	1
CASSLRGAGGYTF	TFEYVSQPFLMDLE	1
CASSPRQGSFGYTF	TFEYVSQPFLMDLE	1
CASSLRGGDGYTF	TFEYVSQPFLMDLE	1
CAWSSSFGYTF	TFEYVSQPFLMDLE	1
CASSGSGHLGYTF	TFEYVSQPFLMDLE	1
CASSVRGRSGNTIYF	TFEYVSQPFLMDLE	1
CASSYSRGSFGYTF	TFEYVSQPFLMDLE	1
CASSVRGAMGYTF	TFEYVSQPFLMDLE	1
CASSFRGPGNEQFF	TFEYVSQPFLMDLE	1
CASSADRGALYGYTF	TFEYVSQPFLMDLE	1
CASSLQGGNGYTF	TFEYVSQPFLMDLE	1
CASSSRGAFGYTF	TFEYVSQPFLMDLE	1
CASSSDRGQIYGYTF	TFEYVSQPFLMDLE	1
CASSNRGRIEQYF	TFEYVSQPFLMDLE	1
CASSYRGGPLSGWNF	TFEYVSQPFLMDLE	1
CASSYRGARTGELFF	TFEYVSQPFLMDLE	1
CASIIRQGAFEQYF	TFEYVSQPFLMDLE	1
CASSSRGGDGYTF	TFEYVSQPFLMDLE	1
CASSFGRGDGYTF	TFEYVSQPFLMDLE	1
CASKRWTSGVGTDTQYF	TFEYVSQPFLMDLE	1
CASTYPGTPYGYTF	TFEYVSQPFLMDLE	1
CASSTTGGNGYTF	TFEYVSQPFLMDLE	1
CASSRWTSGERTDTQYF	TFEYVSQPFLMDLE	1
CAWSVRGAHGYTF	TFEYVSQPFLMDLE	1
CASSYRQGQPQHF	TFEYVSQPFLMDLE	1
CASRNRQQTLYGYTF	TFEYVSQPFLMDLE	1
CASSWRQGGSIRESYTF	TFEYVSQPFLMDLE	1
CASSLSSGWPYGYTF	TFEYVSQPFLMDLE	1
CASSDRGTGLNGYTF	TFEYVSQPFLMDLE	1
CASGPGGMTEAFF	TFEYVSQPFLMDLE	1
CASSKLASTAGEQYF	DRFYKTLRAEQASQEV	1
CASSGGQETQYF	LNKIVRMYSPTSILD	1
CASSWDSNYGYTF	DRFYKTLRAEQASQEV	1
CASSPLVPYEQYF	DRFYKTLRAEQASQEV	1
CASSVGASGLTEQYF	DRFYKTLRAEQASQEV	1
CASRPLATADTQYF	DRFYKTLRAEQASQEV	1
CASRGNHRGNMNTEAFF	DRFYKTLRAEQASQEV	1
CASSEKASGLGEQYF	DRFYKTLRAEQASQEV	1
CASRQGQGPFYGYTF	DRFYKTLRAEQASQEV	1
CASSVLTSGTDTQYF	DRFYKTLRAEQASQEV	1
CASRRTATSPPSFF	DRFYKTLRAEQASQEV	1
CASSRRTSGGTDTQYF	DRFYKTLRAEQASQEV	1
CASSEAASGVGEQYF	DRFYKTLRAEQASQEV	1
CASRATITGNTIYF	DRFYKTLRAEQASQEV	1
CASSRLAGGFDEQFF	DRFYKTLRAEQASQEV	1
CASSRTGGPSYEQYF	DRFYKTLRAEQASQEV	1
CASSLGDSSYTGELFF	DRFYKTLRAEQASQEV	1
CASGRGANSPLHF	DRFYKTLRAEQASQEV	1
CASSQTAQYGYTF	DRFYKTLRAEQASQEV	1
CASSPTGTGTYEQYF	DRFYKTLRAEQASQEV	1
CATSSGGTGRNYGYTF	DRFYKTLRAEQASQEV	1
CASSEGTDYGYTF	MHQKRTAMFQDPQER	1
CASSWERAGKAFF	VVVGAVGVGKSALTIQLIQN	1
CASITGTGGFGYTF	TFEYVSQPFLMDLE	1
CASSLRTSGTGEQFF	TFEYVSQPFLMDLE	1
CASSPRGRGAETQYF	TFEYVSQPFLMDLE	1
CASSPRGPPNTGELFF	TFEYVSQPFLMDLE	1
CASSIRPHDRYTF	TFEYVSQPFLMDLE	1
CASSYRDPLQGQFF	TFEYVSQPFLMDLE	1
CASSFNRRGLENYGYTF	TFEYVSQPFLMDLE	1
CASSGTLGQFF	TFEYVSQPFLMDLE	1
CASSKNPGQLYGYTF	TFEYVSQPFLMDLE	1
CATTSGGALYGYTF	TFEYVSQPFLMDLE	1
CAWSRRGLGYTF	TFEYVSQPFLMDLE	1
CASSAQGALGYTF	TFEYVSQPFLMDLE	1
CASRTLRDSFGGYTF	TFEYVSQPFLMDLE	1
CASSSSQGSLYGYTF	TFEYVSQPFLMDLE	1
CASSMVRDRGIRYTEAFF	TFEYVSQPFLMDLE	1
CASSSDRGGFGYTF	TFEYVSQPFLMDLE	1
CASSDRGLGYTF	TFEYVSQPFLMDLE	1
CASSGRQGSYEQYF	TFEYVSQPFLMDLE	1
CASSVVRGQYYNSPLHF	TFEYVSQPFLMDLE	1
CASSPLRSTGRNGYTF	TFEYVSQPFLMDLE	1
CAWSGRAGGLDGYTF	TFEYVSQPFLMDLE	1
CASSLGRGSLYGYTF	TFEYVSQPFLMDLE	1
CASSTGQGALGYTF	TFEYVSQPFLMDLE	1
CASSARLTVNTGELFF	TFEYVSQPFLMDLE	1
CASSASRAGAASSSTDTQYF	TFEYVSQPFLMDLE	1
CASSHRSGGSNYGYTF	TFEYVSQPFLMDLE	1
CASIRSRGELYGYTF	TFEYVSQPFLMDLE	1
CASGGQGNIHGYTF	TFEYVSQPFLMDLE	1
CASSMVRDRGIRYTEAFF	TFEYVSQPFLMDLE	1
CASSFRGPGNTIYF	TFEYVSQPFLMDLE	1
CASHSGVDTQYF	TFEYVSQPFLMDLE	1
CASSPRLAGSTGELFF	TFEYVSQPFLMDLE	1
CASSLRAGAPTGELFF	TFEYVSQPFLMDLE	1
CASSLRGGSPTGYTF	TFEYVSQPFLMDLE	1
CASSPRDRVNTGELFF	TFEYVSQPFLMDLE	1
CASTARGGNGYTF	TFEYVSQPFLMDLE	1
CASRTKGGLGYTF	TFEYVSQPFLMDLE	1
CASSPRDRLNTGELFF	TFEYVSQPFLMDLE	1
CASSSRQGSPLHF	TFEYVSQPFLMDLE	1
CASSPRDRVASVSGNTIYF	TFEYVSQPFLMDLE	1
CASSPRDRVASVSGNTIYF	TFEYVSQPFLMDLE	1
CASSSQGALNGYTF	TFEYVSQPFLMDLE	1
CASSLTRGAGSIGELFF	TFEYVSQPFLMDLE	1
CASSPDRGLGGYTF	TFEYVSQPFLMDLE	1
CASSSQGALYGYTF	TFEYVSQPFLMDLE	1
CASSYRARVNTGELFF	TFEYVSQPFLMDLE	1
CASSERDRVNTGELFF	TFEYVSQPFLMDLE	1
CASSYASGGRPNTGELFF	TFEYVSQPFLMDLE	1
CATSGRGGFGYTF	TFEYVSQPFLMDLE	1
CASSLRDRLNTGELFF	TFEYVSQPFLMDLE	1
CASSPRGSGNTIYF	TFEYVSQPFLMDLE	1
CATSGRGGFGYTF	TFEYVSQPFLMDLE	1
CASSRRGGDGYTF	TFEYVSQPFLMDLE	1
CASSGRGSFGYTF	TFEYVSQPFLMDLE	1
CASSARDRANTGELFF	TFEYVSQPFLMDLE	1
CASSPPRGGLGYTF	TFEYVSQPFLMDLE	1
CASSVTGGYGYTF	TFEYVSQPFLMDLE	1
CASRGRPGAFGYTF	TFEYVSQPFLMDLE	1
CASSARQGTLRGYTF	TFEYVSQPFLMDLE	1
CASSYRGDYGYTF	TFEYVSQPFLMDLE	1
CAWSPRGTEAFF	TFEYVSQPFLMDLE	1
CASSYRGDYGYTF	TFEYVSQPFLMDLE	1
CASSFRKGSLNGYTF	TFEYVSQPFLMDLE	1
CASSYKRRPNTGELFF	TFEYVSQPFLMDLE	1
CASSLRGLEKLFF	TFEYVSQPFLMDLE	1
CASSFRRDTPNGYTF	TFEYVSQPFLMDLE	1
CASSYSKGSLGYTF	TFEYVSQPFLMDLE	1
CASSATGGVGYTF	TFEYVSQPFLMDLE	1
CASSWGPGSLYGYTF	TFEYVSQPFLMDLE	1
CASSEDGTVTYEQYF	TFEYVSQPFLMDLE	1
CASSYRGDGLYGYTF	TFEYVSQPFLMDLE	1
CASSYRGQGLSGYTF	TFEYVSQPFLMDLE	1
CASSYSEGGLRGYTF	TFEYVSQPFLMDLE	1
CASSLRLRPNTGELFF	TFEYVSQPFLMDLE	1
CASSPDIEAFF	TFEYVSQPFLMDLE	1
CASSYRGDGLYGYTF	TFEYVSQPFLMDLE	1
CASSYSEGGLRGYTF	TFEYVSQPFLMDLE	1
CASSVRTDPSKAFF	TFEYVSQPFLMDLE	1
CASSLRTGQGVRTDTQYF	TFEYVSQPFLMDLE	1
CASSNRYGPYNEQFF	TFEYVSQPFLMDLE	1
CASSFGIGYTF	TFEYVSQPFLMDLE	1
CASHRTGGVYGYTF	TFEYVSQPFLMDLE	1
CASSYRGQGLSGYTF	TFEYVSQPFLMDLE	1
CASSSRRTGFGVNQPQHF	TFEYVSQPFLMDLE	1
CAISEGVGYTF	TFEYVSQPFLMDLE	1
CASSARESPNTGELFF	TFEYVSQPFLMDLE	1
CASSKTAGWEYGYTF	TFEYVSQPFLMDLE	1
CATSDRGQVYGYTF	TFEYVSQPFLMDLE	1
CASSPRPGQGWSPLHF	TFEYVSQPFLMDLE	1
CASSPRDRANTGELFF	TFEYVSQPFLMDLE	1
CASSSRGDYGYTF	TFEYVSQPFLMDLE	1
CASSSREGLGYTF	TFEYVSQPFLMDLE	1
CASSPDRFNGLNTIYF	TFEYVSQPFLMDLE	1
CASSSRQGSLKQYF	TFEYVSQPFLMDLE	1
CASSQAGWNTEAFF	TFEYVSQPFLMDLE	1
CASSPRLPLATGELFF	TFEYVSQPFLMDLE	1
CASSPRTSANTGELFF	TFEYVSQPFLMDLE	1
CASSPRGTEAFF	TFEYVSQPFLMDLE	1
CASSPRTGTPHGYTF	TFEYVSQPFLMDLE	1
CASSHRDRPNTGELFF	TFEYVSQPFLMDLE	1
CASSGTFGYTF	TFEYVSQPFLMDLE	1
CATPTGAFGYTF	TFEYVSQPFLMDLE	1
CASRDRARSDTEAFF	TFEYVSQPFLMDLE	1
CASSDRGALGYTF	TFEYVSQPFLMDLE	1
CASSARGGNGYTF	TFEYVSQPFLMDLE	1
CASSNRGLGYTF	TFEYVSQPFLMDLE	1
CASSAGVGYTF	TFEYVSQPFLMDLE	1
CASSVRDRANTGELFF	TFEYVSQPFLMDLE	1
CASSYRNSGGYGYTF	TFEYVSQPFLMDLE	1
CASSRTGGVGYTF	TFEYVSQPFLMDLE	1
CASSVRDRANTGELFF	TFEYVSQPFLMDLE	1
CASSYRGAYGYTF	TFEYVSQPFLMDLE	1
CASSLGPWETQYF	TFEYVSQPFLMDLE	1
CASSPRRGSLSGYTF	TFEYVSQPFLMDLE	1
CASSYNRGYGYTF	TFEYVSQPFLMDLE	1
CASTQRSGSWVSTDTQYF	TFEYVSQPFLMDLE	1
CASSPRQGSMGYTF	TFEYVSQPFLMDLE	1
CASSEGRLAGPNTGELFF	TFEYVSQPFLMDLE	1
CASSFRQGAREQYF	TFEYVSQPFLMDLE	1
CASSYRQGAIYGYTF	TFEYVSQPFLMDLE	1
CASSPRLAGATGELFF	TFEYVSQPFLMDLE	1
CASSRASGSFGYTF	TFEYVSQPFLMDLE	1
CASSTRAGRLDGYTF	TFEYVSQPFLMDLE	1
CASSPRDRGGLGYTF	TFEYVSQPFLMDLE	1
CASSARLAGATGELFF	TFEYVSQPFLMDLE	1
CASSYRGTVYGYTF	TFEYVSQPFLMDLE	1
CASSYSKSALAGYTF	TFEYVSQPFLMDLE	1
CASIPRPGALGYTF	TFEYVSQPFLMDLE	1
CASIQRRGDYYGYTF	TFEYVSQPFLMDLE	1
CASSDSYPPRTGELFF	TFEYVSQPFLMDLE	1
CASSSRQGMLGGYTF	TFEYVSQPFLMDLE	1
CASSTRGAPLNGYTF	TFEYVSQPFLMDLE	1
CASSYSSGSLSGYTF	TFEYVSQPFLMDLE	1
CASSYRQGAMNGYTF	TFEYVSQPFLMDLE	1
CASSFGRRATNTGELFF	TFEYVSQPFLMDLE	1
CASSSRREVVYGYTF	TFEYVSQPFLMDLE	1
CASSPRQGPLYGYTF	TFEYVSQPFLMDLE	1
CASSYSKSALRGYTF	TFEYVSQPFLMDLE	1
CASSPRQGSLYGYTF	TFEYVSQPFLMDLE	1
CASSTRGPGNTIYF	TFEYVSQPFLMDLE	1
CASRFGTNSYNEQFF	TFEYVSQPFLMDLE	1
CASSLGDRGQLGYGYTF	TFEYVSQPFLMDLE	1
CASSPRGGHGYTF	TFEYVSQPFLMDLE	1
CASRRDRGLEGYTF	TFEYVSQPFLMDLE	1
CASTVPGQLYGYTF	TFEYVSQPFLMDLE	1
CASSSGRGSGYTF	TFEYVSQPFLMDLE	1
CASSPGQGSIYGYTF	TFEYVSQPFLMDLE	1
CASSRTGGSINGYTF	TFEYVSQPFLMDLE	1
CASSARQGIGLGTNEKLFF	TFEYVSQPFLMDLE	1
CASSPGQGSIYGYTF	TFEYVSQPFLMDLE	1
CASSPRGQGNTGELFF	TFEYVSQPFLMDLE	1
CATSPRGAWGYTF	TFEYVSQPFLMDLE	1
CASSQVRGRQFFTNEKLFF	TFEYVSQPFLMDLE	1
CASSYSRGNLGGYTF	TFEYVSQPFLMDLE	1
CASSVVGGLGYTF	TFEYVSQPFLMDLE	1
CASSVVGGLGYTF	TFEYVSQPFLMDLE	1
CASSWGRRGPNTGELFF	TFEYVSQPFLMDLE	1
CASSRRDGNTIYF	TFEYVSQPFLMDLE	1
CASSYGGDTQYF	TFEYVSQPFLMDLE	1
CASSLGTSGLSGFF	TFEYVSQPFLMDLE	1
CASKDRGLANTF	TFEYVSQPFLMDLE	1
CASSGRASALGQFF	TFEYVSQPFLMDLE	1
CASSFGRGSLGYTF	TFEYVSQPFLMDLE	1
CASSPRRTGLGEQYF	TFEYVSQPFLMDLE	1
CANKRDSLRGYTF	TFEYVSQPFLMDLE	1
CASSTGQGSVWGYTF	TFEYVSQPFLMDLE	1
CASSPRLAGGPFGELFF	TFEYVSQPFLMDLE	1
CASSYSRGRPQHF	TFEYVSQPFLMDLE	1
CASSTRQANTGELFF	TFEYVSQPFLMDLE	1
CASSYSRQQGPITGELFF	TFEYVSQPFLMDLE	1
CASSYSRGPPNTGELFF	TFEYVSQPFLMDLE	1
CASSPRSSANTGELFF	TFEYVSQPFLMDLE	1
CASSVVGGLGYTF	TFEYVSQPFLMDLE	1
CASSVRTGGLYGYTF	TFEYVSQPFLMDLE	1
CASSYRGADGYTF	TFEYVSQPFLMDLE	1
CATSDRTGWGYTF	TFEYVSQPFLMDLE	1
CASSPRGTEAFF	TFEYVSQPFLMDLE	1
CASVNRGGQPQHF	TFEYVSQPFLMDLE	1
CASSKRQSTVYGYTF	TFEYVSQPFLMDLE	1
CASRGRGPETQYF	TFEYVSQPFLMDLE	1
CATSLTGGSGYTF	TFEYVSQPFLMDLE	1
CATSPRGAVGYTF	TFEYVSQPFLMDLE	1
CASSERQGSLYGYTF	TFEYVSQPFLMDLE	1
CASSYRGTGIYGYTF	TFEYVSQPFLMDLE	1
CASSVRDRVNTGELFF	TFEYVSQPFLMDLE	1
CASSKNRDSLPYGYTF	TFEYVSQPFLMDLE	1
CSARRGVAGYNEQFF	PSDKHIKEYLNKIQN	1
CSARRGVAGYNEQFF	HIKEYLNKIQNSLST	1
CSARRGVAGYNEQFF	YLNKIQNSLSTEWSP	1
CSARRGVAGYNEQFF	PSDKHIEQYLKKIQNSLSTEWSP	1
CASSLVEGPETQYF	PSDKHIKEYLNKIQN	1
CASSLVEGPETQYF	HIKEYLNKIQNSLST	1
CASSLVEGPETQYF	YLNKIQNSLSTEWSP	1
CASSLVEGPETQYF	PSDKHIEQYLKKIQNSLSTEWSP	1
CASSHIQGPETQYF	PSDKHIKEYLNKIQN	1
CASSHIQGPETQYF	HIKEYLNKIQNSLST	1
CASSHIQGPETQYF	YLNKIQNSLSTEWSP	1
CASSHIQGPETQYF	PSDKHIEQYLKKIQNSLSTEWSP	1
CASSLKGLAGDSYEQYF	PSDKHIKEYLNKIQN	1
CASSLKGLAGDSYEQYF	PSDKHIKEYLNKIQN	1
CASSLKGLAGDSYEQYF	HIKEYLNKIQNSLST	1
CASSLKGLAGDSYEQYF	HIKEYLNKIQNSLST	1
CASSLKGLAGDSYEQYF	YLNKIQNSLSTEWSP	1
CASSLKGLAGDSYEQYF	YLNKIQNSLSTEWSP	1
CASSQVRGGWTGELFF	PSDKHIKEYLNKIQN	1
CASSQVRGGWTGELFF	HIKEYLNKIQNSLST	1
CASSQVRGGWTGELFF	YLNKIQNSLSTEWSP	1
CSARDGGRSSYEQYF	PSDKHIKEYLNKIQN	1
CSARDGGRSSYEQYF	HIKEYLNKIQNSLST	1
CSARDGGRSSYEQYF	YLNKIQNSLSTEWSP	1
CSARDGGRSSYEQYF	PSDKHIKEYLNKIQN	1
CSARDGGRSSYEQYF	HIKEYLNKIQNSLST	1
CSARDGGRSSYEQYF	YLNKIQNSLSTEWSP	1
CSAPTGRVNSPLHF	PSDKHIKEYLNKIQN	1
CSAPTGRVNSPLHF	HIKEYLNKIQNSLST	1
CSAPTGRVNSPLHF	YLNKIQNSLSTEWSP	1
CSATGRRANYGYTF	PSDKHIKEYLNKIQN	1
CSATGRRANYGYTF	HIKEYLNKIQNSLST	1
CSATGRRANYGYTF	YLNKIQNSLSTEWSP	1
CSATPHRANYGYTF	PSDKHIKEYLNKIQN	1
CSATPHRANYGYTF	HIKEYLNKIQNSLST	1
CSATPHRANYGYTF	YLNKIQNSLSTEWSP	1
CSAPRGRMNTEAFF	PSDKHIKEYLNKIQN	1
CSAPRGRMNTEAFF	HIKEYLNKIQNSLST	1
CSAPRGRMNTEAFF	YLNKIQNSLSTEWSP	1
CSAPRRRANYGYTF	PSDKHIKEYLNKIQN	1
CSAPRRRANYGYTF	HIKEYLNKIQNSLST	1
CSAPRRRANYGYTF	YLNKIQNSLSTEWSP	1
CSAPRRRANYGYTF	PSDKHIEQYLKKIQNSLSTEWSP	1
CSATPRRVNYGYTF	PSDKHIKEYLNKIQN	1
CSATPRRVNYGYTF	HIKEYLNKIQNSLST	1
CSATPRRVNYGYTF	YLNKIQNSLSTEWSP	1
CSAPGQRGNSPLHF	PSDKHIKEYLNKIQN	1
CSAPGQRGNSPLHF	HIKEYLNKIQNSLST	1
CSAPGQRGNSPLHF	YLNKIQNSLSTEWSP	1
CSASPPRSNQPQHF	PSDKHIKEYLNKIQN	1
CSASPPRSNQPQHF	HIKEYLNKIQNSLST	1
CSASPPRSNQPQHF	YLNKIQNSLSTEWSP	1
CASSPTTGTTGNTIYF	PSDKHIKEYLNKIQN	1
CASSPTTGTTGNTIYF	HIKEYLNKIQNSLST	1
CASSPTTGTTGNTIYF	YLNKIQNSLSTEWSP	1
CASSPTTGTTGNTIYF	PSDKHIEQYLKKIQNSLSTEWSP	1
CASSQAGTYNSPLHF	PSDKHIKEYLNKIQN	1
CASSQAGTYNSPLHF	HIKEYLNKIQNSLST	1
CASSQAGTYNSPLHF	YLNKIQNSLSTEWSP	1
CASSPDGGTYGYTF	PSDKHIKEYLNKIQN	1
CASSPDGGTYGYTF	HIKEYLNKIQNSLST	1
CASSPDGGTYGYTF	YLNKIQNSLSTEWSP	1
CASTLGQTYKNIQYF	PSDKHIKEYLNKIQN	1
CASTLGQTYKNIQYF	HIKEYLNKIQNSLST	1
CASTLGQTYKNIQYF	YLNKIQNSLSTEWSP	1
CASRRGTKQETQYF	PSDKHIKEYLNKIQN	1
CASRRGTKQETQYF	HIKEYLNKIQNSLST	1
CASRRGTKQETQYF	YLNKIQNSLSTEWSP	1
CASRRGTKQETQYF	PSDKHIEQYLKKIQNSLSTEWSP	1
CASSVDRSGANVLTF	PSDKHIKEYLNKIQN	1
CASSVDRSGANVLTF	HIKEYLNKIQNSLST	1
CASSVDRSGANVLTF	YLNKIQNSLSTEWSP	1
CASSPGGGRGTDTQYF	PSDKHIKEYLNKIQN	1
CASSPGGGRGTDTQYF	PSDKHIKEYLNKIQN	1
CASSPGGGRGTDTQYF	HIKEYLNKIQNSLST	1
CASSPGGGRGTDTQYF	HIKEYLNKIQNSLST	1
CASSPGGGRGTDTQYF	YLNKIQNSLSTEWSP	1
CASSPGGGRGTDTQYF	YLNKIQNSLSTEWSP	1
CASSPGGRSDTQYF	PSDKHIKEYLNKIQN	1
CASSPGGRSDTQYF	PSDKHIKEYLNKIQN	1
CASSPGGRSDTQYF	HIKEYLNKIQNSLST	1
CASSPGGRSDTQYF	HIKEYLNKIQNSLST	1
CASSPGGRSDTQYF	YLNKIQNSLSTEWSP	1
CASSPGGRSDTQYF	YLNKIQNSLSTEWSP	1
CASTPGGRAEEQYF	PSDKHIKEYLNKIQN	1
CASTPGGRAEEQYF	PSDKHIKEYLNKIQN	1
CASTPGGRAEEQYF	HIKEYLNKIQNSLST	1
CASTPGGRAEEQYF	HIKEYLNKIQNSLST	1
CASTPGGRAEEQYF	YLNKIQNSLSTEWSP	1
CASTPGGRAEEQYF	YLNKIQNSLSTEWSP	1
CASSPHRAGDSPLHF	PSDKHIKEYLNKIQN	1
CASSPHRAGDSPLHF	PSDKHIKEYLNKIQN	1
CASSPHRAGDSPLHF	HIKEYLNKIQNSLST	1
CASSPHRAGDSPLHF	HIKEYLNKIQNSLST	1
CASSPHRAGDSPLHF	YLNKIQNSLSTEWSP	1
CASSPHRAGDSPLHF	YLNKIQNSLSTEWSP	1
CASSRERAGDSPLHF	PSDKHIKEYLNKIQN	1
CASSRERAGDSPLHF	PSDKHIKEYLNKIQN	1
CASSRERAGDSPLHF	HIKEYLNKIQNSLST	1
CASSRERAGDSPLHF	HIKEYLNKIQNSLST	1
CASSRERAGDSPLHF	YLNKIQNSLSTEWSP	1
CASSRERAGDSPLHF	YLNKIQNSLSTEWSP	1
CASSPGGRADTQYF	PSDKHIKEYLNKIQN	1
CASSPGGRADTQYF	PSDKHIKEYLNKIQN	1
CASSPGGRADTQYF	HIKEYLNKIQNSLST	1
CASSPGGRADTQYF	HIKEYLNKIQNSLST	1
CASSPGGRADTQYF	YLNKIQNSLSTEWSP	1
CASSPGGRADTQYF	YLNKIQNSLSTEWSP	1
CASSLDRGLNYGYTF	PSDKHIKEYLNKIQN	1
CASSLDRGLNYGYTF	PSDKHIKEYLNKIQN	1
CASSLDRGLNYGYTF	HIKEYLNKIQNSLST	1
CASSLDRGLNYGYTF	HIKEYLNKIQNSLST	1
CASSLDRGLNYGYTF	YLNKIQNSLSTEWSP	1
CASSLDRGLNYGYTF	YLNKIQNSLSTEWSP	1
CASSVAGATYEQYF	PSDKHIKEYLNKIQN	1
CASSVAGATYEQYF	PSDKHIKEYLNKIQN	1
CASSVAGATYEQYF	HIKEYLNKIQNSLST	1
CASSVAGATYEQYF	HIKEYLNKIQNSLST	1
CASSVAGATYEQYF	YLNKIQNSLSTEWSP	1
CASSVAGATYEQYF	YLNKIQNSLSTEWSP	1
CASSVAGEDYGYTF	PSDKHIKEYLNKIQN	1
CASSVAGEDYGYTF	PSDKHIKEYLNKIQN	1
CASSVAGEDYGYTF	HIKEYLNKIQNSLST	1
CASSVAGEDYGYTF	HIKEYLNKIQNSLST	1
CASSVAGEDYGYTF	YLNKIQNSLSTEWSP	1
CASSVAGEDYGYTF	YLNKIQNSLSTEWSP	1
CASSVAGEDYEQYF	PSDKHIKEYLNKIQN	1
CASSVAGEDYEQYF	PSDKHIKEYLNKIQN	1
CASSVAGEDYEQYF	HIKEYLNKIQNSLST	1
CASSVAGEDYEQYF	HIKEYLNKIQNSLST	1
CASSVAGEDYEQYF	YLNKIQNSLSTEWSP	1
CASSVAGEDYEQYF	YLNKIQNSLSTEWSP	1
CASSGGGGRGTDTQYF	PSDKHIKEYLNKIQN	1
CASSGGGGRGTDTQYF	PSDKHIKEYLNKIQN	1
CASSGGGGRGTDTQYF	HIKEYLNKIQNSLST	1
CASSGGGGRGTDTQYF	HIKEYLNKIQNSLST	1
CASSGGGGRGTDTQYF	YLNKIQNSLSTEWSP	1
CASSGGGGRGTDTQYF	YLNKIQNSLSTEWSP	1
CSASTGQAINEQFF	PSDKHIKEYLNKIQN	1
CSASTGQAINEQFF	PSDKHIKEYLNKIQN	1
CSASTGQAINEQFF	HIKEYLNKIQNSLST	1
CSASTGQAINEQFF	HIKEYLNKIQNSLST	1
CSASTGQAINEQFF	YLNKIQNSLSTEWSP	1
CSASTGQAINEQFF	YLNKIQNSLSTEWSP	1
CSARPDRISPLHF	PSDKHIKEYLNKIQN	1
CSARPDRISPLHF	PSDKHIKEYLNKIQN	1
CSARPDRISPLHF	HIKEYLNKIQNSLST	1
CSARPDRISPLHF	HIKEYLNKIQNSLST	1
CSARPDRISPLHF	YLNKIQNSLSTEWSP	1
CSARPDRISPLHF	YLNKIQNSLSTEWSP	1
CASSSGGRSDTQYF	PSDKHIKEYLNKIQN	1
CASSSGGRSDTQYF	PSDKHIKEYLNKIQN	1
CASSSGGRSDTQYF	HIKEYLNKIQNSLST	1
CASSSGGRSDTQYF	HIKEYLNKIQNSLST	1
CASSSGGRSDTQYF	YLNKIQNSLSTEWSP	1
CASSSGGRSDTQYF	YLNKIQNSLSTEWSP	1
CASSWPDRFLSGYTF	PSDKHIKEYLNKIQN	1
CASSWPDRFLSGYTF	PSDKHIKEYLNKIQN	1
CASSWPDRFLSGYTF	HIKEYLNKIQNSLST	1
CASSWPDRFLSGYTF	HIKEYLNKIQNSLST	1
CASSWPDRFLSGYTF	YLNKIQNSLSTEWSP	1
CASSWPDRFLSGYTF	YLNKIQNSLSTEWSP	1
CASSPGGRKETQYF	PSDKHIKEYLNKIQN	1
CASSPGGRKETQYF	PSDKHIKEYLNKIQN	1
CASSPGGRKETQYF	HIKEYLNKIQNSLST	1
CASSPGGRKETQYF	HIKEYLNKIQNSLST	1
CASSPGGRKETQYF	YLNKIQNSLSTEWSP	1
CASSPGGRKETQYF	YLNKIQNSLSTEWSP	1
CASSVAGEDYGYTF	PSDKHIKEYLNKIQN	1
CASSVAGEDYGYTF	PSDKHIKEYLNKIQN	1
CASSVAGEDYGYTF	HIKEYLNKIQNSLST	1
CASSVAGEDYGYTF	HIKEYLNKIQNSLST	1
CASSVAGEDYGYTF	YLNKIQNSLSTEWSP	1
CASSVAGEDYGYTF	YLNKIQNSLSTEWSP	1
CASSVAGGSYEQFF	PSDKHIKEYLNKIQN	1
CASSVAGGSYEQFF	PSDKHIKEYLNKIQN	1
CASSVAGGSYEQFF	HIKEYLNKIQNSLST	1
CASSVAGGSYEQFF	HIKEYLNKIQNSLST	1
CASSVAGGSYEQFF	YLNKIQNSLSTEWSP	1
CASSVAGGSYEQFF	YLNKIQNSLSTEWSP	1
CASSELGTSGRPDTQYF	PSDKHIKEYLNKIQN	1
CASSELGTSGRPDTQYF	HIKEYLNKIQNSLST	1
CASSELGTSGRPDTQYF	YLNKIQNSLSTEWSP	1
CSAKTSGRSVNEQFF	PSDKHIKEYLNKIQN	1
CSAKTSGRSVNEQFF	HIKEYLNKIQNSLST	1
CSAKTSGRSVNEQFF	YLNKIQNSLSTEWSP	1
CSARDSGRSSYEQYF	PSDKHIKEYLNKIQN	1
CSARDSGRSSYEQYF	HIKEYLNKIQNSLST	1
CSARDSGRSSYEQYF	YLNKIQNSLSTEWSP	1
CSARDGGRSSYEQYF	PSDKHIKEYLNKIQN	1
CSARDGGRSSYEQYF	HIKEYLNKIQNSLST	1
CSARDGGRSSYEQYF	YLNKIQNSLSTEWSP	1
CASSRGGTGGNEQFF	PSDKHIKEYLNKIQN	1
CASSRGGTGGNEQFF	HIKEYLNKIQNSLST	1
CASSRGGTGGNEQFF	YLNKIQNSLSTEWSP	1
CASSRGGTGGNEQFF	PSDKHIEQYLKKIQNSLSTEWSP	1
CASTLGSPGANVLTF	PNANPNVDPNANPNV	1
CASTLGSPGANVLTF	PNANPNVDPNANPNV	1
CALLEGTSPWGDEQFF	PNANPNVDPNANPNV	1
CALLEGTSPWGDEQFF	PNANPNVDPNANPNV	1
CAWGRGEGTGELFF	PNANPNVDPNANPNV	1
CAWGRGEGTGELFF	PNANPNVDPNANPNV	1
CAWTQANYGYTF	PNANPNVDPNANPNV	1
CAWTQANYGYTF	PNANPNVDPNANPNV	1
CAWSVAGYAGELFF	PNANPNVDPNANPNV	1
CAWSVAGYAGELFF	PNANPNVDPNANPNV	1
CAWSSWTGGDEKLFF	PNANPNVDPNANPNV	1
CAWSSWTGGDEKLFF	PNANPNVDPNANPNV	1
CAWALHRDSPLHF	PNANPNVDPNANPNV	1
CAWALHRDSPLHF	PNANPNVDPNANPNV	1
CAGDQGSNYGYTF	PNANPNVDPNANPNV	1
CAGDQGSNYGYTF	PNANPNVDPNANPNV	1
CASSRDTHQPQHF	PNANPNVDPNANPNV	1
CASSRDTHQPQHF	PNANPNVDPNANPNV	1
CASSLAGFWSTDTQYF	PNANPNVDPNANPNV	1
CASSLAGFWSTDTQYF	PNANPNVDPNANPNV	1
CSAPQGQKYGYTF	RNVDENANANSAVKN	1
CSAPQGQKYGYTF	RNVDENANANSAVKN	1
CSAPPATLYGYTF	RNVDENANANSAVKN	1
CSAPPATLYGYTF	RNVDENANANSAVKN	1
CASRWTGQTYEQYF	RNVDENANANSAVKN	1
CASRWTGQTYEQYF	RNVDENANANSAVKN	1
CASSDQGGDNEQFF	ATGFKQSSKALQRPVAS	1
CASRGEGYGYTF	PGVLLKEFTVSGNIL	1
CASGYQNQPQHF	PGVLLKEFTVSGNIL	1
CASSTQTELPQHF	PGVLLKEFTVSGNIL	1
CASSVMGTQYF	PGVLLKEFTVSGNIL	1
CASSPLRPSYEQYF	PGVLLKEFTVSGNIL	1
CASSGQGAGTQYF	PGVLLKEFTVSGNIL	1
CASSVMTGLNTEAFF	PGVLLKEFTVSGNIL	1
CASSVIYEQYF	PGVLLKEFTVSGNIL	1
CASSIIYEQYF	PGVLLKEFTVSGNIL	1
CASSGLAGVTGELFF	PGVLLKEFTVSGNIL	1
CASSLAGSQYNSPLHF	SLFFSAQPFEITAST	1
CASSLGGMAIRETQYF	SLFFSAQPFEITAST	1
CASSREGRSYGYTF	SLFFSAQPFEITAST	1
CASSFGRNTEAFF	SLFFSAQPFEITAST	1
CASSFGRNTEAFF	SLFFSAQPFEITAST	1
CSARHRDVGTYGYTF	SLFFSAQPFEITAST	1
CASSPIQVNTGELFF	SLFFSAQPFEITAST	1
CASSLGTGGDTQYF	SLFFSAQPFEITAST	1
CASSTGTGGSYEQYF	SLFFSAQPFEITAST	1
CASSLIRESYGYTF	SLFFSAQPFEITAST	1
CASSSGRYTEAFF	SLFFSAQPFEITAST	1
CASSFPRTGDNEQFF	SLFFSAQPFEITAST	1
CASSQGSAYEQYF	SLFFSAQPFEITAST	1
CASSSIPGQGARQYF	SLFFSAQPFEITAST	1
CASRRESTDTQYF	SLFFSAQPFEITAST	1
CASRRESTDTQYF	SLFFSAQPFEITAST	1
CASTGQTYNEQFF	SLFFSAQPFEITAST	1
CASSHPAQKKETQYF	SLFFSAQPFEITAST	1
CASSMLPASNYGYTF	SLFFSAQPFEITAST	1
CASRSGQAIQETQYF	SLFFSAQPFEITAST	1
CASKPPGNTEAFF	SLFFSAQPFEITAST	1
CSVTRGGRTYEQYF	SLFFSAQPFEITAST	1
CASSQDYSGGTEAFF	SLFFSAQPFEITAST	1
CASSQDYSGGTEAFF	SLFFSAQPFEITAST	1
CAGTGFMNTEAFF	SLFFSAQPFEITAST	1
CASSKAVGNWAEAFF	SLFFSAQPFEITAST	1
CASSVGVGQPQHF	SLFFSAQPFEITAST	1
CASSPHGGQGNDEQYF	SLFFSAQPFEITAST	1
CASTETGGLQETQYF	SLFFSAQPFEITAST	1
CASSLRDRDIGELFF	SLFFSAQPFEITAST	1
CASTVGAGTDTQYF	SLFFSAQPFEITAST	1
CASGLVKGGLTLTQHF	SLFFSAQPFEITAST	1
CASREDRGRESHF	SLFFSAQPFEITAST	1
CASREDRGRESHF	SLFFSAQPFEITAST	1
CASREDRGRESHF	SLFFSAQPFEITAST	1
CASRSTTGLAVYNEQFF	SLFFSAQPFEITAST	1
CASSEGLSSGNTIYF	SLFFSAQPFEITAST	1
CASSGGTVRHTEAFF	SLFFSAQPFEITAST	1
CASSIGALSNQPQHF	SLFFSAQPFEITAST	1
CASSLRTGGETQYF	SLFFSAQPFEITAST	1
CASSLTGSNQPQHF	SLFFSAQPFEITAST	1
CASSQGTARNTEAFF	SLFFSAQPFEITAST	1
CASSLQGPSTDTQYF	SLFFSAQPFEITAST	1
CSAGPGTGSYEQYF	SLFFSAQPFEITAST	1
CSARDRQGNEKLFF	SLFFSAQPFEITAST	1
CSAREGLAGNEQFF	SLFFSAQPFEITAST	1
CSASTPAGGLMEQFF	SLFFSAQPFEITAST	1
CSATQQVYEQFF	SLFFSAQPFEITAST	1
CSVARDISSYEQYF	SLFFSAQPFEITAST	1
CASSLRGVANTEAFF	SLFFSAQPFEITAST	1
CASSVGGLAGTDTQYF	SLFFSAQPFEITAST	1
CASSVGGLAGTDTQYF	SLFFSAQPFEITAST	1
CASGLVKGGLTLTQHF	SLFFSAQPFEITAST	1
CASSAGGVRDEQYF	SLFFSAQPFEITAST	1
CASSYTKTGSSYEQYF	SLFFSAQPFEITAST	1
CASSQDPPTQTYGYTF	SLFFSAQPFEITAST	1
CASSQDPPTQTYGYTF	SLFFSAQPFEITAST	1
CASFRDRAGTGELFF	SLFFSAQPFEITAST	1
CASFRDRAGTGELFF	SLFFSAQPFEITAST	1
CASSLGAGLPYYGYTF	SLFFSAQPFEITAST	1
CASSGDLYEQYF	SLFFSAQPFEITAST	1
CASSVDSYQPQHF	SLFFSAQPFEITAST	1
CASSALDSPRALFF	SLFFSAQPFEITAST	1
CASSFGRRGTLSLPSTQYF	SLFFSAQPFEITAST	1
CASRLAGRSYNEQFF	SLFFSAQPFEITAST	1
CASSQDLGAGGSDTQYF	SLFFSAQPFEITAST	1
CASSQDLGAGGSDTQYF	SLFFSAQPFEITAST	1
CASSQDLGAGGSDTQYF	SLFFSAQPFEITAST	1
CASSQDLGAGGSDTQYF	SLFFSAQPFEITAST	1
CASSQDLGAGGSDTQYF	SLFFSAQPFEITAST	1
CASSQDLGAGGSDTQYF	SLFFSAQPFEITAST	1
CASSPLAGYNEQFF	SLFFSAQPFEITAST	1
CASSYSAGGDVLTF	SLFFSAQPFEITAST	1
CASSYGWTANQPQHF	SLFFSAQPFEITAST	1
CASSIGTVYNQPQHF	SLFFSAQPFEITAST	1
CSAREPRVGTEAFF	SLFFSAQPFEITAST	1
CASSLKLGTGIYGYTF	SLFFSAQPFEITAST	1
CATSDQRADRAVTGANVLTF	SLFFSAQPFEITAST	1
CASSAPTGEYNSPLHF	SLFFSAQPFEITAST	1
CASSAPTGEYNSPLHF	SLFFSAQPFEITAST	1
CASSLGKNIQYF	SLFFSAQPFEITAST	1
CSDPEVNTEAFF	SLFFSAQPFEITAST	1
CSALGPEAFF	SLFFSAQPFEITAST	1
CASSLVPSLASSGDTQYF	SLFFSAQPFEITAST	1
CASSLFQNNEQFF	SLFFSAQPFEITAST	1
CASSLFQNNEQFF	SLFFSAQPFEITAST	1
CASSSLGQSYGYTF	SLFFSAQPFEITAST	1
CASRRGGDSYEQYF	SLFFSAQPFEITAST	1
CSPRDRGKDTQYF	SLFFSAQPFEITAST	1
CASSPDRGRFDTGELFF	SLFFSAQPFEITAST	1
CASSIAGAGMRGNYGYTF	SLFFSAQPFEITAST	1
CASSPPGNSPLHF	SLFFSAQPFEITAST	1
CASSQKGTGQSPLHF	SLFFSAQPFEITAST	1
CASRTTAGADTQYF	SLFFSAQPFEITAST	1
CASRTTAGADTQYF	SLFFSAQPFEITAST	1
CSARDDREGQFF	SLFFSAQPFEITAST	1
CASSLSGTGRNTEAFF	SLFFSAQPFEITAST	1
CSVDTWGSIGETQYF	SLFFSAQPFEITAST	1
CAWSVRGQVTEAFF	SLFFSAQPFEITAST	1
CASRLRDLNTEAFF	SLFFSAQPFEITAST	1
CASSSQREDDEQFF	SLFFSAQPFEITAST	1
CASSHWTGMNTEAFF	SLFFSAQPFEITAST	1
CASRRGGDSYEQYF	SLFFSAQPFEITAST	1
CASSLGTSGGFDTQYF	SLFFSAQPFEITAST	1
CASRQGVGSGELFF	SLFFSAQPFEITAST	1
CASSAGTPPYEQYF	SLFFSAQPFEITAST	1
CASGGGQGVTQPQHF	SLFFSAQPFEITAST	1
CASSTDHYGYTF	SLFFSAQPFEITAST	1
CASSFGQGSQPQHF	SLFFSAQPFEITAST	1
CASSFGQGSQPQHF	SLFFSAQPFEITAST	1
CSVYQYDVLTFSGNTIYF	SLFFSAQPFEITAST	1
CSVYQYDVLTFSGNTIYF	SLFFSAQPFEITAST	1
CASSETAGGSTEAFF	SLFFSAQPFEITAST	1
CASSFLLTGELFF	SLFFSAQPFEITAST	1
CASSVGLAGQETQYF	SLFFSAQPFEITAST	1
CASRTSGITDTQYF	SLFFSAQPFEITAST	1
CASSPQRGEQYF	SLFFSAQPFEITAST	1
CASSLGQGGANVLTF	SLFFSAQPFEITAST	1
CASSEHPGRNTIYF	SLFFSAQPFEITAST	1
CAWSTGTGVYNEQFF	SLFFSAQPFEITAST	1
CAWSTGTGVYNEQFF	SLFFSAQPFEITAST	1
CASSLMGLAGNEQYF	SLFFSAQPFEITAST	1
CASLTDNNEQFF	SPNNFLSYYRLTRFLSRVIK	1
CASSTGQGLETQYF	VFVQSVLPYFVATKLAKIRK	1
CAWSSYNEQFF	VFVQSVLPYFVATKLAKIRK	1
CASSKGQGLGNQPQHF	YNYIASFFIETGFCDSGILS	1
CASRRDLAAFF	AISRKMVELVHFLLLKYRAR	1
CASSPGTGGRETQYF	AISRKMVELVHFLLLKYRAR	1
CASSYWPTRETQYF	SGWGDPHYITFDGTYYTFLD	1
CASSLTGGVSYEQYF	SLLMWITQCFLPVF	1
CASSLGTGGTGELFF	DFHFEVFNFVPCSI	1
CSVQGGLDSNYGYTF	DFHFEVFNFVPCSI	1
CASSLGTGGTGELFF	DFHFEVFNFVPCSI	1
CASSLNTGAGYGYTF	DFHFEVFNFVPCSI	1
CASSLGTGGTGELFF	DFHFEVFNFVPCSI	1
CASSLPSGGAPGTGELFF	DFHFEVFNFVPCSI	1
CSVQGGLDSNYGYTF	DFHFEVFNFVPCSI	1
CASSIATTNTGELFF	FNNFTVSFWLRVPKVSASHLE	1
CASSLETGTNYEQYF	FNNFTVSFWLRVPKVSASHLE	1
CASSLDIGNNEQFF	FNNFTVSFWLRVPKVSASHLE	1
CASSIATTNTGELFF	FNNFTVSFWLRVPKVSASHLE	1
CSVESGQDYGYTF	MTEYKLVVVGAVGVGKSALTIQLI	1
CSASRGATGQPQHF	MTEYKLVVVGAVGVGKSALTIQLI	1
CASRLGNTGELFF	MTEYKLVVVGAGDVGKSALTIQLI	1
CASRQGNTGELFF	MTEYKLVVVGAGDVGKSALTIQLI	1
CSAREGAGGMGTQYF	MTEYKLVVVGAVGVGKSALTIQLI	1
CSASNRLAVNEQFF	MTEYKLVVVGARGVGKSALTIQLI	1
CASSNQLVTGGYGYTF	MTEYKLVVVGARGVGKSALTIQLI	1
CASSTRPGTEAFF	LLEFYLAMPFATP	1
CSARDRIAVYNEQFF	LLEFYLAMPFATP	1
CASTLALGGGANEQFF	LLEFYLAMPFATP	1
CAISRDTRRGQPQHF	LLEFYLAMPFATP	1
CASSPARDGGGNEQFF	LLEFYLAMPFATP	1
CASSVGPDGSNQPQHF	LLEFYLAMPFATP	1
CASSTTGKRGEQYF	LLEFYLAMPFATP	1
CASSLSSGNYYGYTF	LLEFYLAMPFATP	1
CAWGPRGPNYSGNTIYF	LLEFYLAMPFATP	1
CASSQSTVRYGYTF	LLEFYLAMPFATP	1
CASSVGPSGGASELFF	LLEFYLAMPFATP	1
CASSVGPNGSNQPQHF	LLEFYLAMPFATP	1
CASSLGRRGGPYNEQFF	LLEFYLAMPFATP	1
CASSVAPSGVGTQYF	LLEFYLAMPFATP	1
CASSPNRVYGYTF	LLEFYLAMPFATP	1
CASRLRWGAAAGELFF	LLEFYLAMPFATP	1
CASSIRATDTQYF	QLQPFPQPELPY	1
CSASRTSGRAGDEQFF	QLQPFPQPELPY	1
CASSQGQDTEAFF	QLQPFPQPELPY	1
CASSLTVTDTQYF	QLQPFPQPELPY	1
CSASRQVADTQYF	QLQPFPQPELPY	1
CASSLLAGGDTQYF	QLQPFPQPELPY	1
CASSPAGWDTEAFF	QLQPFPQPELPY	1
CASSRTSENTGELFF	QLQPFPQPELPY	1
CASSLAQGGDTQYF	QLQPFPQPELPY	1
CASSLRYTDTQYF	QLQPFPQPELPY	1
CASSQRQGGNTIYF	PQPELPYPQPQL	1
CASSFDGETQYF	QLQPFPQPELPY	1
CASSSLTSGILGEQFF	FPQPEQPFPWQP	1
CSVGAGGSGELFF	QLQPFPQPELPY	1
CASSIRSTDTQYF	PQPELPYPQPQL	1
CASSFRSTDTQYF	PQPELPYPQPQL	1
CASSLRATDTQYF	PQPELPYPQPQL	1
CATSRAGGGGEKLFF	FPQPEQPFPWQP	1
CASSQGSGGNEQFF	FPQPEQPFPWQP	1
CASSLRTTDTQYF	PQPELPYPQPQL	1
CASSIVGSGGYNEQFF	QLQPFPQPELPY	1
CASSLGSFSYEQYF	QLQPFPQPELPY	1
CSAGQGETQYF	QLQPFPQPELPY	1
CASSFGGGAGDTQYF	QLQPFPQPELPY	1
CASSLGGGAGDTQYF	QLQPFPQPELPY	1
CASSFDSNSPLHF	QLQPFPQPELPY	1
CASSLGGGAGDTQYF	QLQPFPQPELPY	1
CASSLSGPNTGELFF	QLQPFPQPELPY	1
CSVGAGGTGELFF	QLQPFPQPELPY	1
CAWSVTGWDTGELFF	QLQPFPQPELPY	1
CAWSPTGWDTGELFF	QLQPFPQPELPY	1
CAWSVTGWDTGELFF	QLQPFPQPELPY	1
CASSFTNTGELFF	QLQPFPQPELPY	1
CASSFDAETQYF	QLQPFPQPELPY	1
CASSQGLAGRQETQYF	QLQPFPQPELPY	1
CASSQGLAGRQETQYF	QLQPFPQPELPY	1
CASSQGLAGREETQYF	QLQPFPQPELPY	1
CASSFRSTDTQYF	PQPELPYPQPQL	1
CASSLRSTDTQYF	PQPELPYPQPQL	1
CASSFRSTDTQYF	PQPELPYPQPQL	1
CASSYRSTDTQYF	PQPELPYPQPQL	1
CASSLRYTDTQYF	PQPELPYPQPQL	1
CASSFRSTDTQYF	PQPELPYPQPQL	1
CASSLRATDTQYF	PQPELPYPQPQL	1
CASSLRSTDTQYF	PQPELPYPQPQL	1
CASSLRWTDTQYF	PQPELPYPQPQL	1
CASSLRFTDTQYF	PQPELPYPQPQL	1
CASSLRHTDTQYF	PQPELPYPQPQL	1
CASSIRSTDTQYF	PQPELPYPQPQL	1
CASSIRSTDTQYF	PQPELPYPQPQL	1
CASSLRSTDTQYF	PQPELPYPQPQL	1
CASSFRSTDTQYF	PQPELPYPQPQL	1
CASSFRSTDTQYF	PQPELPYPQPQL	1
CASSFRSTDTQYF	PQPELPYPQPQL	1
CASSLRSTDTQYF	PQPELPYPQPQL	1
CASSFRSTDTQYF	PQPELPYPQPQL	1
CASSVRSTDTQYF	PQPELPYPQPQL	1
CASSLRYTDTQYF	PQPELPYPQPQL	1
CASSPGQGGDNEQFF	PQQPFPQPEQPFP	1
CASSLGAGGQETQYF	PQQPFPQPEQPFP	1
CASSSTAQETQYF	PQQPFPQPEQPFP	1
CASSLERDGYTF	GQVELGGGNAVEVCK	1
CASSLSASGGATDTQYF	GQVELGGGNAVEVCK	1
CSANRDGGGYTF	GQVELGGGNAVEVCK	1
CAISEGERGSNYGYTF	GQVELGGGNAVEVCK	1
CASSLGPTGTNTEAFF	GQVELGGGNAVEVCK	1
CATSRGNQGPNQPQHF	GQVELGGGNAVEVCK	1
CASSRLDNGYTF	GQVELGGGNAVEVCK	1
CASSWAYNEQFF	GQVELGGGNAVEVCK	1
CASSLLPDRGHEQYF	GQVELGGGNAVEVCK	1
CAISLQGSRSGANVLTF	GQVELGGGNAVEVCK	1
CASSLGPGLRETQYF	GQVELGGGNAVEVCK	1
CSAIAGPNQPQHF	GQVELGGGNAVEVCK	1
CASSHHSTDTQYF	GQVELGGGNAVEVCK	1
CASSLRRGDTIYF	GQVELGGGNAVEVCK	1
CSAYSPGDRDFSNYGYTF	GQVELGGGNAVEVCK	1
CASSLRTAISRTDTQYF	GQVELGGGNAVEVCK	1
CASHRGKGNSPLHF	GQVELGGGNAVEVCK	1
CASSPWEGRMDTEAFF	GQVELGGGNAVEVCK	1
CASSGQGSSYNSPLHF	EEAAGIGILTVI	1
CASSLGNPSTDTQYF	EEAAGIGILTVI	1
CASPILRQPQHF	EEAAGIGILTVI	1
CASSQSGTLYGYTF	EEAAGIGILTVI	1
CASPILRQPQHF	EEAAGIGILTVI	1
CASSPGQGNPEAFF	LLEFYLAMPFATP	1
CASSPGGGAYEQYF	LLEFYLAMPFATP	1
CASSVVPTGNTEAFF	LLEFYLAMPFATP	1
CASLGPLRHEQYF	FRDYVDRFYKTLRAEQASQE	1
CASKPLVSTDTQYF	FRDYVDRFYKTLRAEQASQE	1
CASLERTSGGEQFF	FRDYVDRFYKTLRAEQASQE	1
CASTRDRTKNEQFF	FRDYVDRFYKTLRAEQASQE	1
CASSALASGGDEQFF	FRDYVDRFYKTLRAEQASQE	1
CASSALASGTDTQYF	FRDYVDRFYKTLRAEQASQE	1
CASSELTSRTYEQYF	FRDYVDRFYKTLRAEQASQE	1
CASSERVSGNQPQHF	FRDYVDRFYKTLRAEQASQE	1
CASSPMASGGDEQFF	FRDYVDRFYKTLRAEQASQE	1
CASSRRTSGTYEQYF	FRDYVDRFYKTLRAEQASQE	1
CASSVMASRGNEQFF	FRDYVDRFYKTLRAEQASQE	1
CASQRGARGGNQPQHF	FRDYVDRFYKTLRAEQASQE	1
CASRARTGATNEKLFF	FRDYVDRFYKTLRAEQASQE	1
CASSAKTSGGSDTQYF	FRDYVDRFYKTLRAEQASQE	1
CASSALASGGRDTQYF	FRDYVDRFYKTLRAEQASQE	1
CASSARTSGGLDEQFF	FRDYVDRFYKTLRAEQASQE	1
CASSARTSGGSDTQYF	FRDYVDRFYKTLRAEQASQE	1
CASSKRASGGTDTQYF	FRDYVDRFYKTLRAEQASQE	1
CASSLRTSGGSDTQYF	FRDYVDRFYKTLRAEQASQE	1
CASSRLTSGGRNEQFF	FRDYVDRFYKTLRAEQASQE	1
CASSSKTSGGTDTQYF	FRDYVDRFYKTLRAEQASQE	1
CASSSRTSGGQDEQFF	FRDYVDRFYKTLRAEQASQE	1
CATSRGARGSNQPQHF	FRDYVDRFYKTLRAEQASQE	1
CASARTGGVGYTF	FRDYVDRFYKTLRAEQASQE	1
CASRTSGTYEQYF	FRDYVDRFYKTLRAEQASQE	1
CASKAKTVTYKQYF	FRDYVDRFYKTLRAEQASQE	1
CASKPKAVTYEQYF	FRDYVDRFYKTLRAEQASQE	1
CASRGTATGNTIYF	FRDYVDRFYKTLRAEQASQE	1
CASRPTATNEKLFF	FRDYVDRFYKTLRAEQASQE	1
CASSEYATSNEQFF	FRDYVDRFYKTLRAEQASQE	1
CASSRGQRHRYAVF	FRDYVDRFYKTLRAEQASQE	1
CAISRLAGGMDEQYF	FRDYVDRFYKTLRAEQASQE	1
CASGRLASGTDTQYF	FRDYVDRFYKTLRAEQASQE	1
CASRRGTSGTGELFF	FRDYVDRFYKTLRAEQASQE	1
CASSDGASGVGEQYF	FRDYVDRFYKTLRAEQASQE	1
CASSEAARGNSPLHF	FRDYVDRFYKTLRAEQASQE	1
CASSEGASGLGEQYF	FRDYVDRFYKTLRAEQASQE	1
CASSELASGISEQFF	FRDYVDRFYKTLRAEQASQE	1
CASSELASGLAEQFF	FRDYVDRFYKTLRAEQASQE	1
CASSELASGTGEQFF	FRDYVDRFYKTLRAEQASQE	1
CASSERASGTDEQYF	FRDYVDRFYKTLRAEQASQE	1
CASSERASGVGELFF	FRDYVDRFYKTLRAEQASQE	1
CASSGLASGTDTQYF	FRDYVDRFYKTLRAEQASQE	1
CASSGLASGTGELFF	FRDYVDRFYKTLRAEQASQE	1
CASSGMTSRSYEQYF	FRDYVDRFYKTLRAEQASQE	1
CASSPGLAGTGELFF	FRDYVDRFYKTLRAEQASQE	1
CASSPLTSGTDTQYF	FRDYVDRFYKTLRAEQASQE	1
CASSPRARGNQPQHF	FRDYVDRFYKTLRAEQASQE	1
CASSPRTSGPYEQYF	FRDYVDRFYKTLRAEQASQE	1
CASSPRTSGSYEQYF	FRDYVDRFYKTLRAEQASQE	1
CASSQGLAGTGELFF	FRDYVDRFYKTLRAEQASQE	1
CASSQLARGTDTQYF	FRDYVDRFYKTLRAEQASQE	1
CASSQLVSLRGEQYF	FRDYVDRFYKTLRAEQASQE	1
CASSQRTSGSDEQYF	FRDYVDRFYKTLRAEQASQE	1
CASSQVAGGTATQYF	FRDYVDRFYKTLRAEQASQE	1
CASSRGARGNQPQHF	FRDYVDRFYKTLRAEQASQE	1
CASSRLAGGLGEQFF	FRDYVDRFYKTLRAEQASQE	1
CASSRLAGGMDEQFF	FRDYVDRFYKTLRAEQASQE	1
CASSRLAGGTDEQFF	FRDYVDRFYKTLRAEQASQE	1
CASSRLTSGTDTQYF	FRDYVDRFYKTLRAEQASQE	1
CASSRVTGGMDEQFF	FRDYVDRFYKTLRAEQASQE	1
CASTKLAGGTSEQFF	FRDYVDRFYKTLRAEQASQE	1
CASTKLAWGTYTQYF	FRDYVDRFYKTLRAEQASQE	1
CATTPGASGISEQFF	FRDYVDRFYKTLRAEQASQE	1
CASSERGQGARYEQYF	FRDYVDRFYKTLRAEQASQE	1
CASSRMTGGGTDTQYF	FRDYVDRFYKTLRAEQASQE	1
CASSRRTSGGTDTQYF	FRDYVDRFYKTLRAEQASQE	1
CASHRTYTDTQYF	FRDYVDRFYKTLRAEQASQE	1
CASSGQTNTEAFF	FRDYVDRFYKTLRAEQASQE	1
CASRWTATSYGYTF	FRDYVDRFYKTLRAEQASQE	1
CASSPTTTGYGYTF	FRDYVDRFYKTLRAEQASQE	1
CASHEGAGGFGELFF	FRDYVDRFYKTLRAEQASQE	1
CASHEGAGGYGELFF	FRDYVDRFYKTLRAEQASQE	1
CASSAGTRGVGEQFF	FRDYVDRFYKTLRAEQASQE	1
CASSALASGTDTQYF	FRDYVDRFYKTLRAEQASQE	1
CASSDAASGVGEQYF	FRDYVDRFYKTLRAEQASQE	1
CASSDLASGTNEQFF	FRDYVDRFYKTLRAEQASQE	1
CASSDRASGVGEQFF	FRDYVDRFYKTLRAEQASQE	1
CASSDRTSGPHEQFF	FRDYVDRFYKTLRAEQASQE	1
CASSGLAGGMDEQFF	FRDYVDRFYKTLRAEQASQE	1
CASSPGARGIDEQFF	FRDYVDRFYKTLRAEQASQE	1
CASSPGTSGVGEQFF	FRDYVDRFYKTLRAEQASQE	1
CASSPGTSGVGKQFF	FRDYVDRFYKTLRAEQASQE	1
CASSPRTSGGGEQYF	FRDYVDRFYKTLRAEQASQE	1
CASSPSARGNQPQHF	FRDYVDRFYKTLRAEQASQE	1
CASSPTTSGRGEQYF	FRDYVDRFYKTLRAEQASQE	1
CASSSGTSGAGEQFF	FRDYVDRFYKTLRAEQASQE	1
CASSSGTSGVGEQFF	FRDYVDRFYKTLRAEQASQE	1
CASSVGTSGVGEQYF	FRDYVDRFYKTLRAEQASQE	1
CASSYRTSGPREQFF	FRDYVDRFYKTLRAEQASQE	1
CASSDRTTCGYTF	FRDYVDRFYKTLRAEQASQE	1
CASSERRIYGYTF	FRDYVDRFYKTLRAEQASQE	1
CASRALASGGEQFF	FRDYVDRFYKTLRAEQASQE	1
CASSALASGDKQYF	FRDYVDRFYKTLRAEQASQE	1
CASSALASGDTQYF	FRDYVDRFYKTLRAEQASQE	1
CASSDDRVGDEQFF	FRDYVDRFYKTLRAEQASQE	1
CASSKLASGDEQFF	FRDYVDRFYKTLRAEQASQE	1
CASSVLPGGNDPLF	FRDYVDRFYKTLRAEQASQE	1
CASSVLPGRNEPFF	FRDYVDRFYKTLRAEQASQE	1
CASSVLRGGNEQFF	FRDYVDRFYKTLRAEQASQE	1
CASSVLRGRNEPFF	FRDYVDRFYKTLRAEQASQE	1
CASSVLRGRNEQFF	FRDYVDRFYKTLRAEQASQE	1
CASSVSRGGNKQFF	FRDYVDRFYKTLRAEQASQE	1
CASVLMRTNNEQFF	FRDYVDRFYKTLRAEQASQE	1
CASSRARGCAGKQYF	FRDYVDRFYKTLRAEQASQE	1
CASSALTSGGDEQFF	FRDYVDRFYKTLRAEQASQE	1
CASSARTSGGSEQFF	FRDYVDRFYKTLRAEQASQE	1
CASSARTSGSDEQYF	FRDYVDRFYKTLRAEQASQE	1
CASSDRASGGDTQYF	FRDYVDRFYKTLRAEQASQE	1
CASSDRASGGDTQYF	FRDYVDRFYKTLRAEQASQE	1
CASSDRATGGDTQYF	FRDYVDRFYKTLRAEQASQE	1
CASSEKASGGDTQYF	FRDYVDRFYKTLRAEQASQE	1
CASSELASGGDEQFF	FRDYVDRFYKTLRAEQASQE	1
CASSHKASGGDKQYF	FRDYVDRFYKTLRAEQASQE	1
CASSHMASGGDTQYF	FRDYVDRFYKTLRAEQASQE	1
CASSHRASGGATPYF	FRDYVDRFYKTLRAEQASQE	1
CASSHRASGGDTQYF	FRDYVDRFYKTLRAEQASQE	1
CASSKLASGADEQYF	FRDYVDRFYKTLRAEQASQE	1
CASSKLTRGADKQYF	FRDYVDRFYKTLRAEQASQE	1
CASSKRTSGTYEQYF	FRDYVDRFYKTLRAEQASQE	1
CASSLRTSGSYEQYF	FRDYVDRFYKTLRAEQASQE	1
CASSPRTSGTYEQYF	FRDYVDRFYKTLRAEQASQE	1
CASSPRVFSVGELFF	FRDYVDRFYKTLRAEQASQE	1
CASSQRASGGDEQFF	FRDYVDRFYKTLRAEQASQE	1
CASSRRTSGTYEQYF	FRDYVDRFYKTLRAEQASQE	1
CASSVRTSGSYEQYF	FRDYVDRFYKTLRAEQASQE	1
CASSARISGGLNEQYF	FRDYVDRFYKTLRAEQASQE	1
CASSARTSGGADTQYF	FRDYVDRFYKTLRAEQASQE	1
CASSARTSGGLDEQYF	FRDYVDRFYKTLRAEQASQE	1
CASSARTSGGSDTQYF	FRDYVDRFYKTLRAEQASQE	1
CASSKRTSGGADTQYF	FRDYVDRFYKTLRAEQASQE	1
CASSLRTSGGTDTQYF	FRDYVDRFYKTLRAEQASQE	1
CASSPRTSGGTDTQYF	FRDYVDRFYKTLRAEQASQE	1
CASSRRASGGTTPHYF	FRDYVDRFYKTLRAEQASQE	1
CASSRRTSGGTDTQYF	FRDYVDRFYKTLRAEQASQE	1
CASSRRTSGRADTQYF	FRDYVDRFYKTLRAEQASQE	1
CASSRRTSGSLDTQYF	FRDYVDRFYKTLRAEQASQE	1
CASSTRIRGGTDKQYF	FRDYVDRFYKTLRAEQASQE	1
CASSVRTSGGTDTQYF	FRDYVDRFYKTLRAEQASQE	1
CASRDSNYGYTF	FRDYVDRFYKTLRAEQASQE	1
CASSRRTETQYF	FRDYVDRFYKTLRAEQASQE	1
CASSETRANIQYF	FRDYVDRFYKTLRAEQASQE	1
CASSGLAANEQFF	FRDYVDRFYKTLRAEQASQE	1
CASRAGSVATEAFF	FRDYVDRFYKTLRAEQASQE	1
CASSGRTSGNEQFF	FRDYVDRFYKTLRAEQASQE	1
CASSVVGSYNEQFF	FRDYVDRFYKTLRAEQASQE	1
CASVLMRTNNEQFF	FRDYVDRFYKTLRAEQASQE	1
CASRAGTSGTGELFF	FRDYVDRFYKTLRAEQASQE	1
CASRKGTSGSGKQYF	FRDYVDRFYKTLRAEQASQE	1
CASSEKASGVDEQFF	FRDYVDRFYKTLRAEQASQE	1
CASSERASGHDTQYF	FRDYVDRFYKTLRAEQASQE	1
CASSHRASGGDTQYF	FRDYVDRFYKTLRAEQASQE	1
CASSKLASGADEQYF	FRDYVDRFYKTLRAEQASQE	1
CASSKQASGGDEQYF	FRDYVDRFYKTLRAEQASQE	1
CASREYATSNEQYF	FRDYVDRFYKTLRAEQASQE	1
CASSEMATGLRYTF	FRDYVDRFYKTLRAEQASQE	1
CASSETATGLRYTF	FRDYVDRFYKTLRAEQASQE	1
CASTLTRVNSPLHF	FRDYVDRFYKTLRAEQASQE	1
CASNQRTSGPYEQYF	FRDYVDRFYKTLRAEQASQE	1
CASSDLASGTGEQFF	FRDYVDRFYKTLRAEQASQE	1
CASSEAAGGYGEQFF	FRDYVDRFYKTLRAEQASQE	1
CASSEFARGNQPQHF	FRDYVDRFYKTLRAEQASQE	1
CASSEFVRDNQPQHF	FRDYVDRFYKTLRAEQASQE	1
CASSEFVRGNQPQHF	FRDYVDRFYKTLRAEQASQE	1
CASSEGAAGNQPQHF	FRDYVDRFYKTLRAEQASQE	1
CASSEGARGVGEQFF	FRDYVDRFYKTLRAEQASQE	1
CASSEGASGTGAQYF	FRDYVDRFYKTLRAEQASQE	1
CASSEGASGVGEQFF	FRDYVDRFYKTLRAEQASQE	1
CASSEGTSTFREQFF	FRDYVDRFYKTLRAEQASQE	1
CASSELASGTGELFF	FRDYVDRFYKTLRAEQASQE	1
CASSGAARGNQPQHF	FRDYVDRFYKTLRAEQASQE	1
CASSKLTSGGYEQYF	FRDYVDRFYKTLRAEQASQE	1
CASSPGTSGVGEQFF	FRDYVDRFYKTLRAEQASQE	1
CASSRLAGGFDEQFF	FRDYVDRFYKTLRAEQASQE	1
CASSRLAGGTDTQYF	FRDYVDRFYKTLRAEQASQE	1
CASSRLASGTDTQYF	FRDYVDRFYKTLRAEQASQE	1
CASSVLASGLGEQYF	FRDYVDRFYKTLRAEQASQE	1
CASRQGARGGNQPQHF	FRDYVDRFYKTLRAEQASQE	1
CASSQGARGGNQPQHF	FRDYVDRFYKTLRAEQASQE	1
CASSRLAGGSSYEQYF	FRDYVDRFYKTLRAEQASQE	1
CASSRLTSGGADTQYF	FRDYVDRFYKTLRAEQASQE	1
CASSRRTSGGTDTQYF	FRDYVDRFYKTLRAEQASQE	1
CASSPRASGGEQYF	FRDYVDRFYKTLRAEQASQE	1
CASSVRRNNEKLFF	FRDYVDRFYKTLRAEQASQE	1
CASNRRTSGTYEQYF	FRDYVDRFYKTLRAEQASQE	1
CASSALASGGDTQYF	FRDYVDRFYKTLRAEQASQE	1
CASSARASGGDEQFF	FRDYVDRFYKTLRAEQASQE	1
CASSARTSGGQPQHF	FRDYVDRFYKTLRAEQASQE	1
CASSARTSGNQPQHF	FRDYVDRFYKTLRAEQASQE	1
CASSELASGINEQFF	FRDYVDRFYKTLRAEQASQE	1
CASSELTSGGDEQFF	FRDYVDRFYKTLRAEQASQE	1
CASSKRTSGGDTQYF	FRDYVDRFYKTLRAEQASQE	1
CASSLRTSGGDEQYF	FRDYVDRFYKTLRAEQASQE	1
CASSPLTSATDTQYF	FRDYVDRFYKTLRAEQASQE	1
CASSPRASGGDEQFF	FRDYVDRFYKTLRAEQASQE	1
CASSPRTSGGDEQYF	FRDYVDRFYKTLRAEQASQE	1
CASRLRTSGGTDTQYF	FRDYVDRFYKTLRAEQASQE	1
CASRRLAGFMADTQYF	FRDYVDRFYKTLRAEQASQE	1
CASSARTSAGTDTQYF	FRDYVDRFYKTLRAEQASQE	1
CASSARTSGGADTHYF	FRDYVDRFYKTLRAEQASQE	1
CASSARTSGGADTQYF	FRDYVDRFYKTLRAEQASQE	1
CASSARTSGGSDTQYF	FRDYVDRFYKTLRAEQASQE	1
CASSARTSGGTDTQYF	FRDYVDRFYKTLRAEQASQE	1
CASSERTSGGRDTQYF	FRDYVDRFYKTLRAEQASQE	1
CASSGRTSGGSDTQYF	FRDYVDRFYKTLRAEQASQE	1
CASSLRASGGSDTQYF	FRDYVDRFYKTLRAEQASQE	1
CASSLRTSGGADTQYF	FRDYVDRFYKTLRAEQASQE	1
CASSQRTSGGADTQYF	FRDYVDRFYKTLRAEQASQE	1
CASSRLTSGGSDTQYF	FRDYVDRFYKTLRAEQASQE	1
CASSRRTSGGLDTQYF	FRDYVDRFYKTLRAEQASQE	1
CASSRRTSGGPNEQFF	FRDYVDRFYKTLRAEQASQE	1
CASSRRTSGGTDTQYF	FRDYVDRFYKTLRAEQASQE	1
CASSEGWEPYEQYF	FRDYVDRFYKTLRAEQASQE	1
CASSELTSGGDEQFF	FRDYVDRFYKTLRAEQASQE	1
CASSARTSGGTDTQYF	FRDYVDRFYKTLRAEQASQE	1
CATTAAGTGVDGNYGYTF	FRDYVDRFYKTLRAEQASQE	1
CASKPARANEQFF	FRDYVDRFYKTLRAEQASQE	1
CASKPTRANEQFF	FRDYVDRFYKTLRAEQASQE	1
CASSESHTAGYGYTF	FRDYVDRFYKTLRAEQASQE	1
CASSELAAGTDTQYF	FRDYVDRFYKTLRAEQASQE	1
CASSVLRTVNTEAFF	FRDYVDRFYKTLRAEQASQE	1
CASTLLTSGTGELFF	FRDYVDRFYKTLRAEQASQE	1
CASSRSSGGAYNEQFF	FRDYVDRFYKTLRAEQASQE	1
CASRVRAQGYTF	FRDYVDRFYKTLRAEQASQE	1
CASSVRAQGYTF	FRDYVDRFYKTLRAEQASQE	1
CASRFGTSGGELFF	FRDYVDRFYKTLRAEQASQE	1
CASRPLHSVYEQYF	FRDYVDRFYKTLRAEQASQE	1
CASSAGLARDTQYF	FRDYVDRFYKTLRAEQASQE	1
CASSPLAVQETQYF	FRDYVDRFYKTLRAEQASQE	1
CASRGTVLGGNTIYF	FRDYVDRFYKTLRAEQASQE	1
CASRRLAGGTGELFF	FRDYVDRFYKTLRAEQASQE	1
CASSALASGTDTQYF	FRDYVDRFYKTLRAEQASQE	1
CASSDLASGTDTQYF	FRDYVDRFYKTLRAEQASQE	1
CASSEAASGVGEQYF	FRDYVDRFYKTLRAEQASQE	1
CASSEGAAGNQPQHF	FRDYVDRFYKTLRAEQASQE	1
CASSEGARGSQPQHF	FRDYVDRFYKTLRAEQASQE	1
CASSELASGTDTQYF	FRDYVDRFYKTLRAEQASQE	1
CASSELASGVNEQFF	FRDYVDRFYKTLRAEQASQE	1
CASSELTSGVSEQYF	FRDYVDRFYKTLRAEQASQE	1
CASSERTSGVGEQFF	FRDYVDRFYKTLRAEQASQE	1
CASSGMASGTDTQYF	FRDYVDRFYKTLRAEQASQE	1
CASSLLAGGMDEQFF	FRDYVDRFYKTLRAEQASQE	1
CASSLTTSGTGEQYF	FRDYVDRFYKTLRAEQASQE	1
CASSPGASGVGELFF	FRDYVDRFYKTLRAEQASQE	1
CASSPLTSGTDTQYF	FRDYVDRFYKTLRAEQASQE	1
CASSPVAVSNQPQHF	FRDYVDRFYKTLRAEQASQE	1
CASSQLTSGTDTQYF	FRDYVDRFYKTLRAEQASQE	1
CASSRLAGGMDEQYF	FRDYVDRFYKTLRAEQASQE	1
CASSSRARGNQPQHF	FRDYVDRFYKTLRAEQASQE	1
CASLRSTSGVIDEQFF	FRDYVDRFYKTLRAEQASQE	1
CASRPGLAGGLQETQYF	FRDYVDRFYKTLRAEQASQE	1
CASTETGYGAFF	FRDYVDRFYKTLRAEQASQE	1
CASSEVSGANVLTF	FRDYVDRFYKTLRAEQASQE	1
CASSEWGELNEQYF	FRDYVDRFYKTLRAEQASQE	1
CASSRTGGAETQYF	FRDYVDRFYKTLRAEQASQE	1
CASSGRGSTNEKLFF	FRDYVDRFYKTLRAEQASQE	1
CASRAPGLAFQETQYF	FRDYVDRFYKTLRAEQASQE	1
CASRAPGLAFQGTQYF	FRDYVDRFYKTLRAEQASQE	1
CASSEFRTRGYTF	FRDYVDRFYKTLRAEQASQE	1
CASSEGPGVRNGYTF	FRDYVDRFYKTLRAEQASQE	1
CASTPTVAHSYNEQFF	FRDYVDRFYKTLRAEQASQE	1
CASIVRTSGASYNEQFF	FRDYVDRFYKTLRAEQASQE	1
CASSAPVTDTQYF	FRDYVDRFYKTLRAEQASQE	1
CASSGQTNTEAFF	FRDYVDRFYKTLRAEQASQE	1
CASLGQANTGELFF	FRDYVDRFYKTLRAEQASQE	1
CASRPFATNEKLFF	FRDYVDRFYKTLRAEQASQE	1
CASGVLASGTGELFF	FRDYVDRFYKTLRAEQASQE	1
CASSPGASGVYEQYF	FRDYVDRFYKTLRAEQASQE	1
CASSQGTSGVGEQFF	FRDYVDRFYKTLRAEQASQE	1
CASSEGAGGFGQPQHF	FRDYVDRFYKTLRAEQASQE	1
CASSVSTGGILEKLFF	FRDYVDRFYKTLRAEQASQE	1
CASSDGGIYGYTF	FRDYVDRFYKTLRAEQASQE	1
CASSDRRIYGYTF	FRDYVDRFYKTLRAEQASQE	1
CASRSLVSTGELFF	FRDYVDRFYKTLRAEQASQE	1
CASSEWARGSGELFF	FRDYVDRFYKTLRAEQASQE	1
CASSPRTSGADTQYF	FRDYVDRFYKTLRAEQASQE	1
CASSPRTSGGDEQYF	FRDYVDRFYKTLRAEQASQE	1
CASSPRTSGTYEQYF	FRDYVDRFYKTLRAEQASQE	1
CASSIRTSGGTDTQYF	FRDYVDRFYKTLRAEQASQE	1
CASSLRTSGGSDTQYF	FRDYVDRFYKTLRAEQASQE	1
CASSLRTSGGTDTQYF	FRDYVDRFYKTLRAEQASQE	1
CASSLRTSGGVDTQYF	FRDYVDRFYKTLRAEQASQE	1
CASSPRTSGGSDTQYF	FRDYVDRFYKTLRAEQASQE	1
CASQRGNSYNEQFF	FRDYVDRFYKTLRAEQASQE	1
CASRIRTSGGEQYF	FRDYVDRFYKTLRAEQASQE	1
CASTRDRTKNEQFF	FRDYVDRFYKTLRAEQASQE	1
CASSALASGGDEQFF	FRDYVDRFYKTLRAEQASQE	1
CASSLRTSGGDEQFF	FRDYVDRFYKTLRAEQASQE	1
CASSPMASGGDEQFF	FRDYVDRFYKTLRAEQASQE	1
CASSPRTSGTDTQYF	FRDYVDRFYKTLRAEQASQE	1
CASSRRTSGTYEQYF	FRDYVDRFYKTLRAEQASQE	1
CASSVMASRGNEQFF	FRDYVDRFYKTLRAEQASQE	1
CASNKLTSGGRDTQYF	FRDYVDRFYKTLRAEQASQE	1
CASSARTSGGSDTQYF	FRDYVDRFYKTLRAEQASQE	1
CASSKRTSGATDEQFF	FRDYVDRFYKTLRAEQASQE	1
CASSLLTSGGRETQYF	FRDYVDRFYKTLRAEQASQE	1
CASSRLTSGGRNEQFF	FRDYVDRFYKTLRAEQASQE	1
CASSSRTSGGTDTQYF	FRDYVDRFYKTLRAEQASQE	1
CATSRGARGSNQPQHF	FRDYVDRFYKTLRAEQASQE	1
CASRDGLGELFF	FRDYVDRFYKTLRAEQASQE	1
CASSGQTNTEAFF	FRDYVDRFYKTLRAEQASQE	1
CASSALASGTDTQYF	FRDYVDRFYKTLRAEQASQE	1
CASSELASGQGSQYF	FRDYVDRFYKTLRAEQASQE	1
CASSELASGSYEQYF	FRDYVDRFYKTLRAEQASQE	1
CASSELASGTGEQFF	FRDYVDRFYKTLRAEQASQE	1
CASSPRTSGPYEQYF	FRDYVDRFYKTLRAEQASQE	1
CASSQLTSGTDTQYF	FRDYVDRFYKTLRAEQASQE	1
CASSRLAGGFDEQFF	FRDYVDRFYKTLRAEQASQE	1
CASSRLASGTDTQYF	FRDYVDRFYKTLRAEQASQE	1
CASSRTVSGNQPQHF	FRDYVDRFYKTLRAEQASQE	1
CASSSLASRPYEQYF	FRDYVDRFYKTLRAEQASQE	1
CASTKGASGSGEQFF	FRDYVDRFYKTLRAEQASQE	1
CATTPGASGISEQFF	FRDYVDRFYKTLRAEQASQE	1
CASSERGQGARYEQYF	FRDYVDRFYKTLRAEQASQE	1
CASSRRTSGGTDTQYF	FRDYVDRFYKTLRAEQASQE	1
CASARLAGGTDEQFF	FRDYVDRFYKTLRAEQASQE	1
CASSAKARGNQPQHF	FRDYVDRFYKTLRAEQASQE	1
CASSALAGGTDTQYF	FRDYVDRFYKTLRAEQASQE	1
CASSALASGTDTQYF	FRDYVDRFYKTLRAEQASQE	1
CASSDAASGVGEQYF	FRDYVDRFYKTLRAEQASQE	1
CASSGQARGNQPQHF	FRDYVDRFYKTLRAEQASQE	1
CASSPGTSGVGEQFF	FRDYVDRFYKTLRAEQASQE	1
CASSPSARGNQPQHF	FRDYVDRFYKTLRAEQASQE	1
CASSVGTSGVGEQYF	FRDYVDRFYKTLRAEQASQE	1
CASQASGRSYEQYF	FRDYVDRFYKTLRAEQASQE	1
CASSEFWGQETQYF	FRDYVDRFYKTLRAEQASQE	1
CASSELASGDEQFF	FRDYVDRFYKTLRAEQASQE	1
CASSVSQGSDEQYF	FRDYVDRFYKTLRAEQASQE	1
CASCPMASRSYEQYF	FRDYVDRFYKTLRAEQASQE	1
CASIIGSQGAYGYTF	FRDYVDRFYKTLRAEQASQE	1
CASSALASGGDTQYF	FRDYVDRFYKTLRAEQASQE	1
CASSARASGGDEQFF	FRDYVDRFYKTLRAEQASQE	1
CASSARTSGNQPQHF	FRDYVDRFYKTLRAEQASQE	1
CASSERGTANTEAFF	FRDYVDRFYKTLRAEQASQE	1
CASSFRTSGGDTQYF	FRDYVDRFYKTLRAEQASQE	1
CASSKRASGGDTQYF	FRDYVDRFYKTLRAEQASQE	1
CASSPRASGGDEQFF	FRDYVDRFYKTLRAEQASQE	1
CASSPRTSGGDEQYF	FRDYVDRFYKTLRAEQASQE	1
CASSPRTSGTYEQYF	FRDYVDRFYKTLRAEQASQE	1
CASSPVARGPYEQYF	FRDYVDRFYKTLRAEQASQE	1
CASSQLTSRTYEQYF	FRDYVDRFYKTLRAEQASQE	1
CASSARTSGGSDTQYF	FRDYVDRFYKTLRAEQASQE	1
CASSARTSGGTDTQYF	FRDYVDRFYKTLRAEQASQE	1
CASSGRTSGGSDTQYF	FRDYVDRFYKTLRAEQASQE	1
CASSLRTSGGADTQYF	FRDYVDRFYKTLRAEQASQE	1
CASSLRTSGGSDTQYF	FRDYVDRFYKTLRAEQASQE	1
CASSPLTSGGTDTQYF	FRDYVDRFYKTLRAEQASQE	1
CASSRRTSGASDTQYF	FRDYVDRFYKTLRAEQASQE	1
CASSRRTSGGADEQFF	FRDYVDRFYKTLRAEQASQE	1
CASSRRTSGGTDTQYF	FRDYVDRFYKTLRAEQASQE	1
CASSRRTSGGYDEQFF	FRDYVDRFYKTLRAEQASQE	1
CASSSRTSGGSDTQYF	FRDYVDRFYKTLRAEQASQE	1
CASSVRTSGGSDTQYF	FRDYVDRFYKTLRAEQASQE	1
CASSISLPGTLYYEQYF	FRDYVDRFYKTLRAEQASQE	1
CACRIRTSGGEQYF	FRDYVDRFYKTLRAEQASQE	1
CASARERTKNIQYF	FRDYVDRFYKTLRAEQASQE	1
CASIPRTSGGLQFF	FRDYVDRFYKTLRAEQASQE	1
CASKALVSTDTQYF	FRDYVDRFYKTLRAEQASQE	1
CASKDRTSGDTQYF	FRDYVDRFYKTLRAEQASQE	1
CASRIRTSGGEQYF	FRDYVDRFYKTLRAEQASQE	1
CASRLLVSQETQYF	FRDYVDRFYKTLRAEQASQE	1
CASSPTVNTYEQYF	FRDYVDRFYKTLRAEQASQE	1
CASQLLVQHTDTQYF	FRDYVDRFYKTLRAEQASQE	1
CASSALASGTDTQYF	FRDYVDRFYKTLRAEQASQE	1
CASSPMASGGDEQFF	FRDYVDRFYKTLRAEQASQE	1
CASSPRTSGTYEQYF	FRDYVDRFYKTLRAEQASQE	1
CASSRWASGGDEQFF	FRDYVDRFYKTLRAEQASQE	1
CASSVMASRGNEQFF	FRDYVDRFYKTLRAEQASQE	1
CASSARTSGGGDTQYF	FRDYVDRFYKTLRAEQASQE	1
CASSARTSGGQDEQFF	FRDYVDRFYKTLRAEQASQE	1
CASSARTSGGRDTQYF	FRDYVDRFYKTLRAEQASQE	1
CASSARTSGGSDTQYF	FRDYVDRFYKTLRAEQASQE	1
CASSLLTSGGRETQYF	FRDYVDRFYKTLRAEQASQE	1
CASSRLTSGGRNEQFF	FRDYVDRFYKTLRAEQASQE	1
CASSRRTSGGSDTQYF	FRDYVDRFYKTLRAEQASQE	1
CASSSKTSGGTDTQYF	FRDYVDRFYKTLRAEQASQE	1
CASSGQTNTEAFF	FRDYVDRFYKTLRAEQASQE	1
CASARLAGGTDEQFF	FRDYVDRFYKTLRAEQASQE	1
CASSAMASGSDTQYF	FRDYVDRFYKTLRAEQASQE	1
CASSELASGTDTQYF	FRDYVDRFYKTLRAEQASQE	1
CASSPGTSGVGEQFF	FRDYVDRFYKTLRAEQASQE	1
CASSPSARGNQPQHF	FRDYVDRFYKTLRAEQASQE	1
CASSVGTSGVGEQYF	FRDYVDRFYKTLRAEQASQE	1
CASSALASGGDTQYF	FRDYVDRFYKTLRAEQASQE	1
CASSRLAGGMDEQFF	FRDYVDRFYKTLRAEQASQE	1
CASSRRTSGGTDTQYF	FRDYVDRFYKTLRAEQASQE	1
CAVQAGGNNRLAF	VELGGGPGA	1
CIAIYNFNKFYF	VELGGGPGA	1
CIVSHNAGNMLTF	VELGGGPGA	1
CALKYGANNLFF	QVELGGGPGAG	1
CIVRVEIQGAQKLVF	QVELGGGPG	1
CAGGFSDGQKLLF	AGSLQPLALE	1
CALSRAGTGNQFYF	AGSLQPLAL	1
CALPREYGNKLVF	AALALLLLDRLNQLE	1
CALSEASGGSYIPTF	AALALLLLDRLNQLE	1
CAGQNYGGSQGNLIF	NCTFEYVSQPFLMDL	1
CAGMNYGGSQGNLIF	NCTFEYVSQPFLMDL	1
CAGMNYGGSQGNLIF	NCTFEYVSQPFLMDL	1
CAGYNSGGSNYKLTF	NCTFEYVSQPFLMDL	1
CAATLFSGTYKYIF	RISNCVADYSVLYNS	1
CAVSEISGTYKYIF	VGGNYNYLYRLFRKS	1
CAVSLKDSSYKLIF	VGGNYNYLYRLFRKS	1
CATDRGNMLTF	VGGNYNYLYRLFRKS	1
CALPNTGFQKLVF	VGGNYNYLYRLFRKS	1
CVVTPTPFSGGYNKLIF	NNSYECDIPIGAGIC	1
CALSGRNYGQNFVF	NNSYECDIPIGAGIC	1
CATADSGGSNYKLTF	HWFVTQRNFYEPQII	1
CAYRSHNSGNTPLVF	HWFVTQRNFYEPQII	1
CAGPRSGGGADGLTF	HWFVTQRNFYEPQII	1
CAAEGGGGNKLTF	HWFVTQRNFYEPQII	1
CIEYNFNKFYF	PQPELPYPQPE	1
CALSELSIQGAQKLVF	PQPELPYPQPE	1
CAVN	PQPELPYPQPE	1
CALSESGANSKLTF	PQPELPYPQPE	1
CLVGHGSSNTGKLIF	PQPELPYPQPE	1
CAVRDPLYNFNKFYF	PQPELPYPQPE	1
CLVGGGADGLTF	PQPELPYPQPE	1
CAGDSGYALNF	PQPELPYPQPE	1
CAASEGDSGTYKYIF	QLQPFPQPELPY	1
CAVKFASGTYKYIF	QLQPFPQPELPY	1
CAMREGWQAGNTLIF	QLQPFPQPELPY	1
CAVVDASSKLIF	PQQPFPQPEQPFP	1
CLVGGYNNNDMRF	PQQPFPQPEQPFP	1
CAESRYSGYSTLTF	PQQPFPQPEQPFP	1
CALSEYGNKLVF	PQQPFPQPEQPFP	1
CAYRSGYMEYGNKLVF	PFPQPELPY	1
CLVGDNDYKLSF	PFPQPELPY	1
TTDSWGKFEF	PFPQPELPY	1
CAAPGGATNKLIF	PFPQPELPY	1
CAVGWEDGTASKLTF	PFPQPELPY	1
CLVGDGGSFSGGYNKLIF	PFPQPELPY	1
CAVQADGNTGKLIF	PFPQPELPY	1
CAGPYNTDKLIF	PFPQPELPY	1
CAASANYGGATNKLIF	PFPQPELPY	1
CAVTLGGGSEKLVF	PFPQPELPY	1
CAVGAGSNYQLIW	PFPQPELPY	1
CLVAGAGGYNKLIF	PFPQPELPY	1
CAGPSGATNKLIF	PFPQPELPY	1
CIAFQGAQKLVF	PQPELPYPQ	1
CLVGEAAGNKLTF	PQPELPYPQ	1
CAVGRGGSQGNLIF	PQPELPYPQ	1
CAMREGRGAGSYQLTF	PQPELPYPQ	1
CAMSVLSGTYKYIF	PQPELPYPQ	1
CAENMRGSNYKLTF	PKYVKQNTLKLAT	1
GDEAGTALIF	PKYVKQNTLKLAT	1
CVVNTGGSQGNLIF	PKYVKQNTLKLAT	1
CAVDDSQGSQGNLIF	PKYVKQNTLKLAT	1
CALSATNTGNQFYF	PKYVKQNTLKLAT	1
CALNRGYGGSQGNLIF	PKYVKQNTLKLAT	1
CALKPGTGNQFYF	PKYVKQNTLKLAT	1
CALSKTGGGADGLTF	PKYVKQNTLKLAT	1
CIVRVYSGGYQKVTF	PKYVKQNTLKLAT	1
CAAKAPYGQNFVF	PKYVKQNTLKLAT	1
CAVTSMNRDDKIIF	PKYVKQNTLKLAT	1
CALTRSAGNNRKLIW	PKYVKQNTLKLAT	1
CAGGGAGKSTF	PKYVKQNTLKLAT	1
CALSEAGAGSYQLTF	PKYVKQNTLKLAT	1
CALSTGGTSYGKLTF	PKYVKQNTLKLAT	1
CAENRDYKLSF	PKYVKQNTLKLAT	1
CATDAGAGGTSYGKLTF	PKYVKQNTLKLAT	1
CAGEGGSEKLVF	PKYVKQNTLKLAT	1
CALRMNTGNQFYF	PKYVKQNTLKLAT	1
CAVIVIQGAQKLVF	PKYVKQNTLKLAT	1
CAMRVTGANSKLTF	PKYVKQNTLKLAT	1
CAMSAKDAGGTSYGKLTF	PKYVKQNTLKLAT	1
CAFNTNAGKSTF	PKYVKQNTLKLAT	1
CAVDSSSNTGKLIF	PKYVKQNTLKLAT	1
CALSELANTDKLIF	PKYVKQNTLKLAT	1
CALSGLGYGNKLVF	PKYVKQNTLKLAT	1
CALSEADYGGSQGNLIF	PKYVKQNTLKLAT	1
CLVRGTGFQKLVF	PKYVKQNTLKLAT	1
CAVTEDDKIIF	PKYVKQNTLKLAT	1
CAMKGGSEKLVF	PKYVKQNTLKLAT	1
CAMNENGNEKLTF	PKYVKQNTLKLAT	1
CALSDQDDYKLSF	PKYVKQNTLKLAT	1
CALSDGAGGYNKLIF	PKYVKQNTLKLAT	1
CAANADAGGTSYGKLTF	PKYVKQNTLKLAT	1
CAVNIRGADGLTF	PKYVKQNTLKLAT	1
CASQSNTGNQFYF	PKYVKQNTLKLAT	1
CAVDLYNARLMF	PKYVKQNTLKLAT	1
CAVEDKDSSYKLIF	PKYVKQNTLKLAT	1
YGSTDKLIF	PKYVKQNTLKLAT	1
CAVFTSGTYKYIF	PKYVKQNTLKLAT	1
CAGAAGANNLFF	PKYVKQNTLKLAT	1
CAESPGANNLFF	PKYVKQNTLKLAT	1
CIVTVPNRDDKIIF	PKYVKQNTLKLAT	1
CILRRGGSNYKLTF	PKYVKQNTLKLAT	1
CAVVNSGYSTLTF	PKYVKQNTLKLAT	1
CAMRSSGTYKYIF	PKYVKQNTLKLAT	1
CAVGGNQFYF	PKYVKQNTLKLAT	1
CALITGGGNKLTF	VVRHCPHHERCSDSD	1
CAWNSGGSNYKLTF	RNTFRHSVVVPCE	1
CAVRVWDYKLSF	HYNYMCNSSCMGSMN	1
CAVKGDYKLSF	HYNYMCNSSCMGSMN	1
CAVTLSGGYNKLIF	SCMGGMNWRPILTII	1
CILRRLNDYKLSF	NSKEETGHLENGN	1
CVVSAAQAGTALIF	DPPALASTNAEVT	1
CAMSAGANTGNQFYF	DPPALASTNAEVT	1
CILRAPSGNTPLVF	DPPALASTNAEVT	1
CALSDPQIKAAGNKLTF	DPPALASTNAEVT	1
CAVAPSQAGTALIF	DPPALASTNAEVT	1
CAFMKRTNRDDKIIF	DPPALASTNAEVT	1
CVVFTGGGNKLTF	GYNSYSVSNSEKHIM	1
CVVFGGNNARLMF	GYNSYSVSNSEKHIM	1
CAVGRSNSGGYQKVTF	GAVGVGKSAL	1
CAVTVVNAGNNRKLIW	GAVGVGKSAL	1
CAVSVNTDKLIF	YVMAYVMAGVGS	1
CAMRRWWDSNYQLIW	KALARALKEGRIR	1
CAVTPNSGGYQKVTF	NHVVDISKSGLITIA	1
CIVKTNSGGSNYKLTF	TAAQAAVVRFQEAAN	1
CIVHTNSGGSNYKLTF	TAAQAAVVRFQEAAN	1
CIEHTNSGGSNYKLTF	TAAQAAVVRFQEAAN	1
CAVGGLSGANSKLTF	MHVSFVMAYPEMLAA	1
CAGAGGGGFKTIF	MHVSFVMAYPEMLAA	1
CAGTNTGNQFYF	MHVSFVMAYPEMLAA	1
CAGPTGGSYIPTF	MHVSFVMAYPEMLAA	1
CVVSAITNDYKLSF	PSPSMGRDIKVQFQS	1
CAVQPGAGGFKTIF	PSPSMGRDIKVQFQS	1
CAVTIGATQGGSEKLVF	PSPSMGRDIKVQFQS	1
CASQSNTGNQFYF	PSPSMGRDIKVQFQS	1
CAVNGGGSNYKLTF	MSQIMYNYPAMLGHA	1
CAVNSGGSNYKLTF	MSQIMYNYPAMLGHA	1
CAVSRAGAGSYQLTF	AAVVRFQEAANKQKQ	1
CAVRDPGNTDKLIF	AAVVRFQEAANKQKQ	1
CAASINSGNTPLVF	PPQIAANRSQLISLV	1
CAASINSGNTPLVF	PPQIAANRSQLISLV	1
CALMNSGGYQKVTF	STRQALRPRADGPVG	1
CALILSGGYQKVTF	STRQALRPRADGPVG	1
NSGGYQKVTF	STRQALRPRADGPVG	1
CALRGDTGRRALTF	STRQALRPRADGPVG	1
CALLNSGGYQKVTF	STRQALRPRADGPVG	1
CALVYSGGYQKVTF	STRQALRPRADGPVG	1
CAVRDSGNTGKLIF	LTDEQRAAALEKAAA	1
CAVSLNDYKLSF	LTDEQRAAALEKAAA	1
CAVTSNDYKLSF	LTDEQRAAALEKAAA	1
CIVSHNAGNMLTF	GQVELGGGPGAESCQ	1
CIVSHNAGNMLTF	GQVELGGGSSPETCI	1
CIVRVAIEGSQGNLIF	GQVELGGGNAVEVCK	1
CIVRVAIEGSQGNLIF	GQVELGGGTPIESCQ	1
CIVSHNAGNMLTF	GQVELGGGNAVEVCK	1
CAVSESPFGNEKLTF	PKYVKQNTLKLAT	1
CAVSESPFGNEKLTF	PKYVKQNTLKLAT	1
CALSGGDSSYKLIF	VHFFKNIVTPRTPG	1
CAALIQGAQKLVF	GELIGILNAAKVPAD	1
CAALIQGAQKLVF	GELIGTLNAAKVPAD	1
CAGAGSQGNLIF	PKYVKQNTLKLAT	1
CAVDSATSGTYKYIF	PKYVKQNTLKLAT	1
CAVDRGSTLGRLYF	GELIGILNAAKVPAD	1
CILRDGRGGADGLTF	SGEGSFQPSQENP	1
CIAFQGAQKLVF	APQPELPYPQPGS	1
CIVLGGADGLTF	APQPELPYPQPGS	1
CIVWGGATNKLIF	APQPELPYPQPG	1
CLVGDGGSFSGGYNKLIF	QPFPQPELPYP	1
CAASVYAGGTSYGKLTF	QPLALEGSLQKRG	1
CAASSSAGGTSYGKLTF	LQPLALEGSLQKRG	1
CILRDRSNQFYF	PSGEGSFQPSQENPQ	1
CILRDSRAQKLVF	SGEGSFQPSQENP	1
CAVGETGANNLFF	PSGEGSFQPSQENPQ	1
CATDTTSGTYKYIF	ENPVVHFFKNIVTP	1
CATDTTSGTYKYIF	MDFARVHFISALHGSG	1
CTVYGGATNKLIF	FSWGAEGQRPGF	1
CAASSFGNEKLTF	NPVVHFFKNIVTPR	1
CTVYGGATNKLIF	FSWGAEGQRPGFGSGG	1
CAASSFGNEKLTF	RLLMLFAKDVVSRN	1
CAVGASGNTGKLIF	QHIRCNIPKRISA	1
CAASSFGNEKLTF	QLVHFVRDFAQL	1
CALSLYSGAGSYQLTF	QAFWIDLFETIG	1
CAVALNNNAGNMLTF	APSGEGSFQPSQENPQ	1
CAVQFMDSNYQLIW	QPQQSFPEQEA	1
CAVQASGGSYIPTF	GPQQSFPEQEA	1
CAFKAAGNKLTF	RFYKTLRAEQASQ	1
CAFKAAGNKLTF	RFYKTLRAEQASQ	1
CAFKAAGNKLTF	RFYKTLRAEQASQ	1
CAFKAAGNKLTF	RFYKTLRAEQASQ	1
CATDAGYNQGGKLIF	VEELYLVAGEEGCGGGGSL	1
CATDAGYNQGGKLIF	VEELYLVAGEEGCGGGGSL	1
CAVHTGARLMF	APFSEQEQPVLG	1
CASPQGGSEKLVF	APFSEQEQPVLG	1
CAVGAGSNYQLIW	APMPMPELPYP	1
CIAFQGAQKLVF	AVVQSELPYPEGS	1
CAFFGQGAQKLVF	GQVELGGGNAVEVCKGS	1
CAVQAGGNNRLAF	GQVELGGGNAVEVCK	1
CIVSHNAGNMLTF	GQVELGGGNAVEVCKGS	1
CALSGGTSYGKLTF	QPFPQPEQPFP	1
CLVGGLARDMRF	LQPFPQPELPYGSGGS	1
CLVGGLARDMRF	LQPFPQPELPYGSGGS	1
CIVSHNAGNMLTF	GQVELGGGPGAESCQ	1
CIVSHNAGNMLTF	GQVELGGGSSPETCI	1
CIVRVAIEGSQGNLIF	GQVELGGGNAVEVCK	1
CIVRVAIEGSQGNLIF	GQVELGGGTPIESCQ	1
CIVSHNAGNMLTF	GQVELGGGNAVEVCK	1
CAVQAGGNNRLAF	GQVELGGGNAVEVCK	1
CAFFGQGAQKLVF	GQVELGGGNAVEVCK	1
CIVRVWYNTDKLIF	TFEYVSQPFLMDLE	1
CAVRRPGTQKLVF	TFEYVSQPFLMDLE	1
CAGQLAGGSNYQLIW	TFEYVSQPFLMDLE	1
CAGQNYGGSQGNLIF	TFEYVSQPFLMDLE	1
CAVQLSPSGANSKLTF	TFEYVSQPFLMDLE	1
CAGQLYGGSQGNLIF	TFEYVSQPFLMDLE	1
CAGLNYGGSQGNLIF	TFEYVSQPFLMDLE	1
CAGHLYSGAGSYQLTF	TFEYVSQPFLMDLE	1
CAGQLATGTASKLTF	TFEYVSQPFLMDLE	1
CAGLLFGGSQGNLIF	TFEYVSQPFLMDLE	1
CAVRWRGKDGAGGADGLTF	TFEYVSQPFLMDLE	1
CAGMNYGGSQGNLIF	TFEYVSQPFLMDLE	1
CAVLNYGGSQGNLIF	TFEYVSQPFLMDLE	1
CAGLNYGGSQGNLIF	TFEYVSQPFLMDLE	1
CAGRNSGGSNYKLTF	TFEYVSQPFLMDLE	1
CAGLLYGGSQGNLIF	TFEYVSQPFLMDLE	1
CAGQNYGGSQGNLIF	TFEYVSQPFLMDLE	1
CVVSDRWEYGNKLVF	TFEYVSQPFLMDLE	1
CAARYDGQNFVF	TFEYVSQPFLMDLE	1
CAGQLYTGTASKLTF	TFEYVSQPFLMDLE	1
CAGLNYGGSQGNLIF	TFEYVSQPFLMDLE	1
CAAQNYGGSQGNLIF	TFEYVSQPFLMDLE	1
CAGLNYGGSQGNLIF	TFEYVSQPFLMDLE	1
CAGMNYGGSQGNLIF	TFEYVSQPFLMDLE	1
CAGMNYGGSQGNLIF	TFEYVSQPFLMDLE	1
CAGLNYGGSQGNLIF	TFEYVSQPFLMDLE	1
CAGQNYGGSQGNLIF	TFEYVSQPFLMDLE	1
CAALNYGGSQGNLIF	TFEYVSQPFLMDLE	1
CAGQNYGGSQGNLIF	TFEYVSQPFLMDLE	1
CAALNYGGSQGNLIF	TFEYVSQPFLMDLE	1
CAARNYGGSQGNLIF	TFEYVSQPFLMDLE	1
CAGLNYGGSQGNLIF	TFEYVSQPFLMDLE	1
CAALNYGGSQGNLIF	TFEYVSQPFLMDLE	1
CAGRNYGGSQGNLIF	TFEYVSQPFLMDLE	1
CAGLNYGGSQGNLIF	TFEYVSQPFLMDLE	1
CAGRNYGGSQGNLIF	TFEYVSQPFLMDLE	1
CAAMNYGGSQGNLIF	TFEYVSQPFLMDLE	1
CAGFNYGGSQGNLIF	TFEYVSQPFLMDLE	1
CAVMNYGGSQGNLIF	TFEYVSQPFLMDLE	1
CAGLNYGGSQGNLIF	TFEYVSQPFLMDLE	1
CAGLNYGGSQGNLIF	TFEYVSQPFLMDLE	1
CAGQNYGGSQGNLIF	TFEYVSQPFLMDLE	1
CAGQLYGGSQGNLIF	TFEYVSQPFLMDLE	1
CAGLNYGGSQGNLIF	TFEYVSQPFLMDLE	1
CAAMNYGGSQGNLIF	TFEYVSQPFLMDLE	1
CAGQNYGGSQGNLIF	TFEYVSQPFLMDLE	1
CATMNYGGSQGNLIF	TFEYVSQPFLMDLE	1
CAGQLYGGSQGNLIF	TFEYVSQPFLMDLE	1
CAGQNYGGSQGNLIF	TFEYVSQPFLMDLE	1
CAGANYGGSQGNLIF	TFEYVSQPFLMDLE	1
CAALNYGGSQGNLIF	TFEYVSQPFLMDLE	1
CAGQLFGGSQGNLIF	TFEYVSQPFLMDLE	1
CAGQLYGGSQGNLIF	TFEYVSQPFLMDLE	1
CALLNYGGSQGNLIF	TFEYVSQPFLMDLE	1
CAGQNYGGSQGNLIF	TFEYVSQPFLMDLE	1
CAGLNYGGSQGNLIF	TFEYVSQPFLMDLE	1
CAGQNYGGSQGNLIF	TFEYVSQPFLMDLE	1
CAGQNYGGSQGNLIF	TFEYVSQPFLMDLE	1
CAGQLYGGSQGNLIF	TFEYVSQPFLMDLE	1
CAGRNYGGSQGNLIF	TFEYVSQPFLMDLE	1
CAGMNYGGSQGNLIF	TFEYVSQPFLMDLE	1
CAVLNYGGSQGNLIF	TFEYVSQPFLMDLE	1
CAGLNSGGSNYKLTF	TFEYVSQPFLMDLE	1
CAGLNYGGSQGNLIF	TFEYVSQPFLMDLE	1
CAGMNYGGSQGNLIF	TFEYVSQPFLMDLE	1
CAGQNYGGSQGNLIF	TFEYVSQPFLMDLE	1
CAALNYGGSQGNLIF	TFEYVSQPFLMDLE	1
CAGMNYGGSQGNLIF	TFEYVSQPFLMDLE	1
CARMNYGGSQGNLIF	TFEYVSQPFLMDLE	1
CASLNYGGSQGNLIF	TFEYVSQPFLMDLE	1
CAGANYGGSQGNLIF	TFEYVSQPFLMDLE	1
CAAMNYGGSQGNLIF	TFEYVSQPFLMDLE	1
CAALNYGGSQGNLIF	TFEYVSQPFLMDLE	1
CAALNYGGSQGNLIF	TFEYVSQPFLMDLE	1
CAGANYGGSQGNLIF	TFEYVSQPFLMDLE	1
CAGRNYGGSQGNLIF	TFEYVSQPFLMDLE	1
CAGFNYGGSQGNLIF	TFEYVSQPFLMDLE	1
CAGQNYGGSQGNLIF	TFEYVSQPFLMDLE	1
CAGQLYGGSQGNLIF	TFEYVSQPFLMDLE	1
CAGMNYGGSQGNLIF	TFEYVSQPFLMDLE	1
CAALNYGGSQGNLIF	TFEYVSQPFLMDLE	1
CAGLNYGGSQGNLIF	TFEYVSQPFLMDLE	1
CAGLLFKAAGNKLTF	TFEYVSQPFLMDLE	1
CAVMNYGGSQGNLIF	TFEYVSQPFLMDLE	1
CAGMNYGGSQGNLIF	TFEYVSQPFLMDLE	1
CAGQNYGGSQGNLIF	TFEYVSQPFLMDLE	1
CAGQLYGGSQGNLIF	TFEYVSQPFLMDLE	1
CAGQNSGGSNYKLTF	TFEYVSQPFLMDLE	1
CASMNYGGSQGNLIF	TFEYVSQPFLMDLE	1
CAGLNYGGSQGNLIF	TFEYVSQPFLMDLE	1
CATLNYGGSQGNLIF	TFEYVSQPFLMDLE	1
NTGNQFYF	TFEYVSQPFLMDLE	1
CAGMNYGGSQGNLIF	TFEYVSQPFLMDLE	1
CAGLNYGGSQGNLIF	TFEYVSQPFLMDLE	1
CAGQLYGGSQGNLIF	TFEYVSQPFLMDLE	1
CAALNYGGSQGNLIF	TFEYVSQPFLMDLE	1
CAGSNYGGSQGNLIF	TFEYVSQPFLMDLE	1
CAGMNYGGATNKLIF	TFEYVSQPFLMDLE	1
CAGLNYGGSQGNLIF	TFEYVSQPFLMDLE	1
CAGLNYGGSQGNLIF	TFEYVSQPFLMDLE	1
CAPMNYGGSQGNLIF	TFEYVSQPFLMDLE	1
CAGRNYGGSQGNLIF	TFEYVSQPFLMDLE	1
CAGLNYGGSQGNLIF	TFEYVSQPFLMDLE	1
CAGQNYGGSQGNLIF	TFEYVSQPFLMDLE	1
CAGMNYGGSQGNLIF	TFEYVSQPFLMDLE	1
CAGRNYGGSQGNLIF	TFEYVSQPFLMDLE	1
CAAMNYGGSQGNLIF	TFEYVSQPFLMDLE	1
CAGQNYGGSQGNLIF	TFEYVSQPFLMDLE	1
CAGLNYGGSQGNLIF	TFEYVSQPFLMDLE	1
CAGLNYGGSQGNLIF	TFEYVSQPFLMDLE	1
CAGQNYGGSQGNLIF	TFEYVSQPFLMDLE	1
CAGLNYGGSQGNLIF	TFEYVSQPFLMDLE	1
CAGMNYGGSQGNLIF	TFEYVSQPFLMDLE	1
CAGQNYGGSQGNLIF	TFEYVSQPFLMDLE	1
CAGMNYGGSQGNLIF	TFEYVSQPFLMDLE	1
CAGQNYGGSQGNLIF	TFEYVSQPFLMDLE	1
CAAMNYGGSQGNLIF	TFEYVSQPFLMDLE	1
CAGQNYGGSQGNLIF	TFEYVSQPFLMDLE	1
CAGLNYGGSQGNLIF	TFEYVSQPFLMDLE	1
CAGLNYGGSQGNLIF	TFEYVSQPFLMDLE	1
CAGQNYGGSQGNLIF	TFEYVSQPFLMDLE	1
CAGCLYGGSQGNLIF	TFEYVSQPFLMDLE	1
CAGQNYGGSQGNLIF	TFEYVSQPFLMDLE	1
CAGRNYGGSQGNLIF	TFEYVSQPFLMDLE	1
CAGQNYGGSQGNLIF	TFEYVSQPFLMDLE	1
CAGLNYGGSQGNLIF	TFEYVSQPFLMDLE	1
CAGMNYGGSQGNLIF	TFEYVSQPFLMDLE	1
CAGQNYGGSQGNLIF	TFEYVSQPFLMDLE	1
CAGLNYGGSQGNLIF	TFEYVSQPFLMDLE	1
CAGMNYGGSQGNLIF	TFEYVSQPFLMDLE	1
CAAQNYGGSQGNLIF	TFEYVSQPFLMDLE	1
CGTEINNDMRF	TFEYVSQPFLMDLE	1
CAGRNYGGSQGNLIF	TFEYVSQPFLMDLE	1
CAGLNYGGSQGNLIF	TFEYVSQPFLMDLE	1
CAVMNYGGSQGNLIF	TFEYVSQPFLMDLE	1
CAPMNYGGSQGNLIF	TFEYVSQPFLMDLE	1
CAVVGNAGGTSYGKLTF	TFEYVSQPFLMDLE	1
CAGQNYGGSQGNLIF	TFEYVSQPFLMDLE	1
CAGQNYGGSQGNLIF	TFEYVSQPFLMDLE	1
CAGMNYGGSQGNLIF	TFEYVSQPFLMDLE	1
CAGQNYGGSQGNLIF	TFEYVSQPFLMDLE	1
CAALNYGGSQGNLIF	TFEYVSQPFLMDLE	1
CAPPPDNYGQNFVF	TFEYVSQPFLMDLE	1
CAGQNYGGSQGNLIF	TFEYVSQPFLMDLE	1
CAGQNYGGSQGNLIF	TFEYVSQPFLMDLE	1
CAGQLHKAAGNKLTF	TFEYVSQPFLMDLE	1
CAALNSGGSNYKLTF	TFEYVSQPFLMDLE	1
CVVRELFSDGQKLLF	TFEYVSQPFLMDLE	1
CAGMNYGGSQGNLIF	TFEYVSQPFLMDLE	1
CAGLNYGGSQGNLIF	TFEYVSQPFLMDLE	1
CAGRNYGGSQGNLIF	TFEYVSQPFLMDLE	1
CAGQLYGGSQGNLIF	TFEYVSQPFLMDLE	1
CAAMNYGGSQGNLIF	TFEYVSQPFLMDLE	1
CAGLLYKAAGNKLTF	TFEYVSQPFLMDLE	1
CAVSPGNAGNMLTF	TFEYVSQPFLMDLE	1
CAGRNYGGSQGNLIF	TFEYVSQPFLMDLE	1
CAGHNYGGSQGNLIF	TFEYVSQPFLMDLE	1
CAGQNYGGSQGNLIF	TFEYVSQPFLMDLE	1
CAGMNYGGSQGNLIF	TFEYVSQPFLMDLE	1
CAGLNYGGSQGNLIF	TFEYVSQPFLMDLE	1
CAGLNYGGSQGNLIF	TFEYVSQPFLMDLE	1
CAGQNYGGSQGNLIF	TFEYVSQPFLMDLE	1
CAAQNYGGSQGNLIF	TFEYVSQPFLMDLE	1
CAGFNSGGSNYKLTF	TFEYVSQPFLMDLE	1
CAGQLFKAAGNKLTF	TFEYVSQPFLMDLE	1
CAGNQGGKLIF	TFEYVSQPFLMDLE	1
CAGQLYGGSQGNLIF	TFEYVSQPFLMDLE	1
CAVWPLNSGGSNYKLTF	TFEYVSQPFLMDLE	1
CAGQLFKAAGNKLTF	TFEYVSQPFLMDLE	1
CAGSNYGGSQGNLIF	TFEYVSQPFLMDLE	1
CAGQNYGGSQGNLIF	TFEYVSQPFLMDLE	1
CAGQNYGGSQGNLIF	TFEYVSQPFLMDLE	1
CAGMNYGGSQGNLIF	TFEYVSQPFLMDLE	1
CAGLNYGGSQGNLIF	TFEYVSQPFLMDLE	1
CAGQNYGGSQGNLIF	TFEYVSQPFLMDLE	1
CAGQNYGGSQGNLIF	TFEYVSQPFLMDLE	1
CAGKNYGGSQGNLIF	TFEYVSQPFLMDLE	1
CAGLNSGGSNYKLTF	TFEYVSQPFLMDLE	1
CAGLNYGGSQGNLIF	TFEYVSQPFLMDLE	1
CAGLNYGGSQGNLIF	TFEYVSQPFLMDLE	1
CAAQNYGGSQGNLIF	TFEYVSQPFLMDLE	1
CAGLNYGGSQGNLIF	TFEYVSQPFLMDLE	1
CAGQNYGGSQGNLIF	TFEYVSQPFLMDLE	1
CAALNYGGSQGNLIF	TFEYVSQPFLMDLE	1
CAGMNYGGSQGNLIF	TFEYVSQPFLMDLE	1
CAGMNYGGSQGNLIF	TFEYVSQPFLMDLE	1
CAAANYGGSQGNLIF	TFEYVSQPFLMDLE	1
CAGMNYGGSQGNLIF	TFEYVSQPFLMDLE	1
CAVLNYGGSQGNLIF	TFEYVSQPFLMDLE	1
CAGLNYGGSQGNLIF	TFEYVSQPFLMDLE	1
CAGLNYGGSQGNLIF	TFEYVSQPFLMDLE	1
CAGFNYGGSQGNLIF	TFEYVSQPFLMDLE	1
CAGMNYGGSQGNLIF	TFEYVSQPFLMDLE	1
CAGQNYGGSQGNLIF	TFEYVSQPFLMDLE	1
CAGLNYGGSQGNLIF	TFEYVSQPFLMDLE	1
CAASRFRNQGGKLIF	TFEYVSQPFLMDLE	1
CAASVRYNQGGKLIF	TFEYVSQPFLMDLE	1
CAGMNYGGSQGNLIF	TFEYVSQPFLMDLE	1
CAGMNYGGSQGNLIF	TFEYVSQPFLMDLE	1
CAGTNYGGSQGNLIF	TFEYVSQPFLMDLE	1
CAFMNYGGSQGNLIF	TFEYVSQPFLMDLE	1
CAGLNYGGSQGNLIF	TFEYVSQPFLMDLE	1
CAGRNYGGSQGNLIF	TFEYVSQPFLMDLE	1
CAALLYGGSQGNLIF	TFEYVSQPFLMDLE	1
CAGQNYGGSQGNLIF	TFEYVSQPFLMDLE	1
CAGLNYGGSQGNLIF	TFEYVSQPFLMDLE	1
CAGQNYGGSQGNLIF	TFEYVSQPFLMDLE	1
CAGQNYGGSQGNLIF	TFEYVSQPFLMDLE	1
CAGQNYGGSQGNLIF	TFEYVSQPFLMDLE	1
CAGLNYGGSQGNLIF	TFEYVSQPFLMDLE	1
CAGQNYGGSQGNLIF	TFEYVSQPFLMDLE	1
CAGLNYGGSQGNLIF	TFEYVSQPFLMDLE	1
CAGLNYGGSQGNLIF	TFEYVSQPFLMDLE	1
CAGMNYGGSQGNLIF	TFEYVSQPFLMDLE	1
CAGQNYGGSQGNLIF	TFEYVSQPFLMDLE	1
CAGLNYGGSQGNLIF	TFEYVSQPFLMDLE	1
CAGQNYGGSQGNLIF	TFEYVSQPFLMDLE	1
CAALNYGGSQGNLIF	TFEYVSQPFLMDLE	1
CAGQNYGGSQGNLIF	TFEYVSQPFLMDLE	1
CAGFNYGGSQGNLIF	TFEYVSQPFLMDLE	1
CAGLNYGGSQGNLIF	TFEYVSQPFLMDLE	1
CAGQLYGGSQGNLIF	TFEYVSQPFLMDLE	1
CAGMNYGGSQGNLIF	TFEYVSQPFLMDLE	1
CAVLNYGGSQGNLIF	TFEYVSQPFLMDLE	1
CAGQNYGGSQGNLIF	TFEYVSQPFLMDLE	1
CAGFNYGGSQGNLIF	TFEYVSQPFLMDLE	1
CAGLNYGGSQGNLIF	TFEYVSQPFLMDLE	1
CAALNYGGSQGNLIF	TFEYVSQPFLMDLE	1
CAGMNYGGSQGNLIF	TFEYVSQPFLMDLE	1
CAGLNYGGSQGNLIF	TFEYVSQPFLMDLE	1
CAAMNYGGSQGNLIF	TFEYVSQPFLMDLE	1
TFVQRPRKNFNKFYF	TFEYVSQPFLMDLE	1
CAGQNYGGSQGNLIF	TFEYVSQPFLMDLE	1
CAGRNYGGSQGNLIF	TFEYVSQPFLMDLE	1
CAGMNYGGSQGNLIF	TFEYVSQPFLMDLE	1
CAGLNYGGSQGNLIF	TFEYVSQPFLMDLE	1
CINTGTASKLTF	TFEYVSQPFLMDLE	1
CAAMNYGGSQGNLIF	TFEYVSQPFLMDLE	1
CAHPGGPGRRALTF	TFEYVSQPFLMDLE	1
CAGMNYGGSQGNLIF	TFEYVSQPFLMDLE	1
CAGQLYGGSQGNLIF	TFEYVSQPFLMDLE	1
CAGLNYGGSQGNLIF	TFEYVSQPFLMDLE	1
CAGLNYGGSQGNLIF	TFEYVSQPFLMDLE	1
CAALNYGGSQGNLIF	TFEYVSQPFLMDLE	1
CAGLNYGGSQGNLIF	TFEYVSQPFLMDLE	1
CALSHYSGTYKYIF	MHQKRTAMFQDPQER	1
CAENSGGSNYKLTF	VVVGAVGVGKSALTIQLIQN	1
CAALNYGGSQGNLIF	TFEYVSQPFLMDLE	1
CAGQLYGGSQGNLIF	TFEYVSQPFLMDLE	1
CAGQLYGGSQGNLIF	TFEYVSQPFLMDLE	1
CAGQNYGGSQGNLIF	TFEYVSQPFLMDLE	1
CAGRNYGGSQGNLIF	TFEYVSQPFLMDLE	1
CAVSNYGGSQGNLIF	TFEYVSQPFLMDLE	1
CAGQLSGGSNYKLTF	TFEYVSQPFLMDLE	1
CAGFLYTGANSKLTF	TFEYVSQPFLMDLE	1
CAGMNYGGSQGNLIF	TFEYVSQPFLMDLE	1
CAALNYGGSQGNLIF	TFEYVSQPFLMDLE	1
CAGLNYGGSQGNLIF	TFEYVSQPFLMDLE	1
CAGMNYGGSQGNLIF	TFEYVSQPFLMDLE	1
NYGGSQGNLIF	TFEYVSQPFLMDLE	1
CAAQNYGGSQGNLIF	TFEYVSQPFLMDLE	1
CAGLNYGGSQGNLIF	TFEYVSQPFLMDLE	1
CAGMNYGGSQGNLIF	TFEYVSQPFLMDLE	1
CAGMNYGGSQGNLIF	TFEYVSQPFLMDLE	1
CAGQNYGGSQGNLIF	TFEYVSQPFLMDLE	1
CAGQNYGGSQGNLIF	TFEYVSQPFLMDLE	1
CAGQNYGGSQGNLIF	TFEYVSQPFLMDLE	1
CAGRNYGGSQGNLIF	TFEYVSQPFLMDLE	1
CASLNYGGSQGNLIF	TFEYVSQPFLMDLE	1
CASQNYGGSQGNLIF	TFEYVSQPFLMDLE	1
CAVMNYGGSQGNLIF	TFEYVSQPFLMDLE	1
CAAKTSDCSLTF	TFEYVSQPFLMDLE	1
CAGLNYGGSQGNLIF	TFEYVSQPFLMDLE	1
CAGQLYGGSQGNLIF	TFEYVSQPFLMDLE	1
CAGQNYGGSQGNLIF	TFEYVSQPFLMDLE	1
CAGQNYGGSQGNLIF	TFEYVSQPFLMDLE	1
CAGMNYGGSQGNLIF	TFEYVSQPFLMDLE	1
CAGLNYGGSQGNLIF	TFEYVSQPFLMDLE	1
CAGQNYGGSQGNLIF	TFEYVSQPFLMDLE	1
CAGHNYGGSQGNLIF	TFEYVSQPFLMDLE	1
CAGLNYGGSQGNLIF	TFEYVSQPFLMDLE	1
CAGLNYGGSQGNLIF	TFEYVSQPFLMDLE	1
CAGMNYGGSQGNLIF	TFEYVSQPFLMDLE	1
CAGMNYGGSQGNLIF	TFEYVSQPFLMDLE	1
CAGMNYGGSQGNLIF	TFEYVSQPFLMDLE	1
CAGMNYGGSQGNLIF	TFEYVSQPFLMDLE	1
CAGQNYGGSQGNLIF	TFEYVSQPFLMDLE	1
CAGLNYGGSQGNLIF	TFEYVSQPFLMDLE	1
CAGLNYGGSQGNLIF	TFEYVSQPFLMDLE	1
CAGQLYGGSQGNLIF	TFEYVSQPFLMDLE	1
CAGMNYGGSQGNLIF	TFEYVSQPFLMDLE	1
CAGLNYGGSQGNLIF	TFEYVSQPFLMDLE	1
FPRASGGSYIPTF	TFEYVSQPFLMDLE	1
CAGLNYGGSQGNLIF	TFEYVSQPFLMDLE	1
CAGQLYGGSQGNLIF	TFEYVSQPFLMDLE	1
CAGQNYGGSQGNLIF	TFEYVSQPFLMDLE	1
CAGSNYGGSQGNLIF	TFEYVSQPFLMDLE	1
CAGQLFKAAGNKLTF	TFEYVSQPFLMDLE	1
CAGMNYGGSQGNLIF	TFEYVSQPFLMDLE	1
CAGQNYGGSQGNLIF	TFEYVSQPFLMDLE	1
CAGQNYGGSQGNLIF	TFEYVSQPFLMDLE	1
CAGQNYGGSQGNLIF	TFEYVSQPFLMDLE	1
CAAHNSGGSNYKLTF	TFEYVSQPFLMDLE	1
CAAMNYGGSQGNLIF	TFEYVSQPFLMDLE	1
CAGLNYGGSQGNLIF	TFEYVSQPFLMDLE	1
CAGRNYGGSQGNLIF	TFEYVSQPFLMDLE	1
CAVNWGDKLIF	TFEYVSQPFLMDLE	1
CAGLNYGGATNKLIF	TFEYVSQPFLMDLE	1
CAGLNYGGATNKLIF	TFEYVSQPFLMDLE	1
CAGLLYGGSQGNLIF	TFEYVSQPFLMDLE	1
CAGLNYGGSQGNLIF	TFEYVSQPFLMDLE	1
CAGLNYGGSQGNLIF	TFEYVSQPFLMDLE	1
CAGLNYGGSQGNLIF	TFEYVSQPFLMDLE	1
CAGMNYGGSQGNLIF	TFEYVSQPFLMDLE	1
CAGMNYGGSQGNLIF	TFEYVSQPFLMDLE	1
CAGMNYGGSQGNLIF	TFEYVSQPFLMDLE	1
CAGQNYGGSQGNLIF	TFEYVSQPFLMDLE	1
CAGQNYGGSQGNLIF	TFEYVSQPFLMDLE	1
CAGRNYGGSQGNLIF	TFEYVSQPFLMDLE	1
CASMNYGGSQGNLIF	TFEYVSQPFLMDLE	1
CAGQLYKAAGNKLTF	TFEYVSQPFLMDLE	1
CAAMNYGGSQGNLIF	TFEYVSQPFLMDLE	1
CAGLNYGGSQGNLIF	TFEYVSQPFLMDLE	1
CAGMNYGGSQGNLIF	TFEYVSQPFLMDLE	1
CAGMNYGGSQGNLIF	TFEYVSQPFLMDLE	1
CAGMNYGGSQGNLIF	TFEYVSQPFLMDLE	1
CALRAGTYKYIF	TFEYVSQPFLMDLE	1
CAGQLYGGSQGNLIF	TFEYVSQPFLMDLE	1
CAGQLHKAAGNKLTF	TFEYVSQPFLMDLE	1
CAGMNYGGSQGNLIF	TFEYVSQPFLMDLE	1
CAGQNYGGSQGNLIF	TFEYVSQPFLMDLE	1
CAGRNYGGSQGNLIF	TFEYVSQPFLMDLE	1
CAYLNYGGSQGNLIF	TFEYVSQPFLMDLE	1
CAGHLFKAAGNKLTF	TFEYVSQPFLMDLE	1
CAGFNYGGSQGNLIF	TFEYVSQPFLMDLE	1
CAGLNYGGSQGNLIF	TFEYVSQPFLMDLE	1
CAGLNYGGSQGNLIF	TFEYVSQPFLMDLE	1
CAGMNYGGSQGNLIF	TFEYVSQPFLMDLE	1
CAGQNYGGRQGNLIF	TFEYVSQPFLMDLE	1
CAGQNYGGSQGNLIF	TFEYVSQPFLMDLE	1
CAGQNYGGSQGNLIF	TFEYVSQPFLMDLE	1
CAGQNYGGSQGNLIF	TFEYVSQPFLMDLE	1
CAVMNYGGSQGNLIF	TFEYVSQPFLMDLE	1
CAVSLISSGSARQLTF	TFEYVSQPFLMDLE	1
CAGLNYGGSQGNLIF	TFEYVSQPFLMDLE	1
CAALNYGGSQGNLIF	TFEYVSQPFLMDLE	1
CAALNYGGSQGNLIF	TFEYVSQPFLMDLE	1
CAAMNYGGSQGNLIF	TFEYVSQPFLMDLE	1
CAAQNYGGSQGNLIF	TFEYVSQPFLMDLE	1
CAGKNYGGSQGNLIF	TFEYVSQPFLMDLE	1
CAGLNYGGSQGNLIF	TFEYVSQPFLMDLE	1
CAGLNYGGSQGNLIF	TFEYVSQPFLMDLE	1
CAGLNYGGSQGNLIF	TFEYVSQPFLMDLE	1
CAGLNYGGSQGNLIF	TFEYVSQPFLMDLE	1
CAGLNYGGSQGNLIF	TFEYVSQPFLMDLE	1
CAGMNYGGSQGNLIF	TFEYVSQPFLMDLE	1
CAGMNYGGSQGNLIF	TFEYVSQPFLMDLE	1
CAGQNYGGSQGNLIF	TFEYVSQPFLMDLE	1
CAGQNYGGSQGNLIF	TFEYVSQPFLMDLE	1
CAGQNYGGSQGNLIF	TFEYVSQPFLMDLE	1
CAGQNYGGSQGNLIF	TFEYVSQPFLMDLE	1
CAGQNYGGSQGNLIF	TFEYVSQPFLMDLE	1
CAGSNYGGSQGNLIF	TFEYVSQPFLMDLE	1
CAVANYGGSQGNLIF	TFEYVSQPFLMDLE	1
CAVQNYGGSQGNLIF	TFEYVSQPFLMDLE	1
CAGHNSGGSNYKLTF	TFEYVSQPFLMDLE	1
CAGLNSGGSNYKLTF	TFEYVSQPFLMDLE	1
FRAGKQGAQKLVF	TFEYVSQPFLMDLE	1
CAVGYGNKLVF	TFEYVSQPFLMDLE	1
CATSTSGTYKYIF	TFEYVSQPFLMDLE	1
IKAAGNKLTF	TFEYVSQPFLMDLE	1
CAGLNYGGSQGNLIF	TFEYVSQPFLMDLE	1
CAGLNYGGSQGNLIF	TFEYVSQPFLMDLE	1
CAGLNYGGSQGNLIF	TFEYVSQPFLMDLE	1
CAGMNYGGSQGNLIF	TFEYVSQPFLMDLE	1
CAGMNYGGSQGNLIF	TFEYVSQPFLMDLE	1
CAGQNYGGSQGNLIF	TFEYVSQPFLMDLE	1
CAGQNYGGSQGNLIF	TFEYVSQPFLMDLE	1
CAGRNYGGSQGNLIF	TFEYVSQPFLMDLE	1
CAGQNYGGSQGNLIF	TFEYVSQPFLMDLE	1
CALPMNSGGSNYKLTF	TFEYVSQPFLMDLE	1
NSGGSNYKLTF	TFEYVSQPFLMDLE	1
NYGGSQGNLIF	TFEYVSQPFLMDLE	1
CAGQLHKAAGNKLTF	TFEYVSQPFLMDLE	1
CAGQLHRAAGNKLTF	TFEYVSQPFLMDLE	1
CAGSLHKAAGNKLTF	TFEYVSQPFLMDLE	1
CAAKNYGGSQGNLIF	TFEYVSQPFLMDLE	1
CAGANYGGSQGNLIF	TFEYVSQPFLMDLE	1
CAGLNYGGSQGNLIF	TFEYVSQPFLMDLE	1
CAGLNYGGSQGNLIF	TFEYVSQPFLMDLE	1
CAGLNYGGSQGNLIF	TFEYVSQPFLMDLE	1
CAGLNYGGSQGNLIF	TFEYVSQPFLMDLE	1
CAGMNYGGSQGNLIF	TFEYVSQPFLMDLE	1
CAGQLYGGSQGNLIF	TFEYVSQPFLMDLE	1
CAGQNYGGSQGNLIF	TFEYVSQPFLMDLE	1
CAGQNYGGSQGNLIF	TFEYVSQPFLMDLE	1
CAGQNYGGSQGNLIF	TFEYVSQPFLMDLE	1
CAGQNYGGSQGNLIF	TFEYVSQPFLMDLE	1
CVGMNYGGSQGNLIF	TFEYVSQPFLMDLE	1
CAGQNSGGSNYKLTF	TFEYVSQPFLMDLE	1
CAGQLFKAAGNKLTF	TFEYVSQPFLMDLE	1
CAGQLQKAAGNKLTF	TFEYVSQPFLMDLE	1
CAGANYGGSQGNLIF	TFEYVSQPFLMDLE	1
CAGMNYGGSQGNLIF	TFEYVSQPFLMDLE	1
CAGMNYGGSQGNLIF	TFEYVSQPFLMDLE	1
CAGMNYGGSQGNLIF	TFEYVSQPFLMDLE	1
CAGMNYGGSQGNLIF	TFEYVSQPFLMDLE	1
CAGMNYGGSQGNLIF	TFEYVSQPFLMDLE	1
CAGQNYGGSQGNLIF	TFEYVSQPFLMDLE	1
CAVIPSGNTPLVF	PSDKHIKEYLNKIQN	1
CAVIPSGNTPLVF	HIKEYLNKIQNSLST	1
CAVIPSGNTPLVF	YLNKIQNSLSTEWSP	1
CAVIPSGNTPLVF	PSDKHIEQYLKKIQNSLSTEWSP	1
CACRTQAGTALIF	PSDKHIKEYLNKIQN	1
CACRTQAGTALIF	HIKEYLNKIQNSLST	1
CACRTQAGTALIF	YLNKIQNSLSTEWSP	1
CACRTQAGTALIF	PSDKHIEQYLKKIQNSLSTEWSP	1
CAEKNQAGTALIF	PSDKHIKEYLNKIQN	1
CAEKNQAGTALIF	HIKEYLNKIQNSLST	1
CAEKNQAGTALIF	YLNKIQNSLSTEWSP	1
CAEKNQAGTALIF	PSDKHIEQYLKKIQNSLSTEWSP	1
CAVRPHNYGQNFVF	PSDKHIKEYLNKIQN	1
CAVRPHNYGQNFVF	PSDKHIKEYLNKIQN	1
CAVRPHNYGQNFVF	HIKEYLNKIQNSLST	1
CAVRPHNYGQNFVF	HIKEYLNKIQNSLST	1
CAVRPHNYGQNFVF	YLNKIQNSLSTEWSP	1
CAVRPHNYGQNFVF	YLNKIQNSLSTEWSP	1
CATDEVRDTDKLIF	PSDKHIKEYLNKIQN	1
CATDEVRDTDKLIF	HIKEYLNKIQNSLST	1
CATDEVRDTDKLIF	YLNKIQNSLSTEWSP	1
CALRGSARLMF	PSDKHIKEYLNKIQN	1
CALRGSARLMF	HIKEYLNKIQNSLST	1
CALRGSARLMF	YLNKIQNSLSTEWSP	1
CALRGQGGKLIF	PSDKHIKEYLNKIQN	1
CALRGQGGKLIF	HIKEYLNKIQNSLST	1
CALRGQGGKLIF	YLNKIQNSLSTEWSP	1
CAFSNFGNEKLTF	PSDKHIKEYLNKIQN	1
CAFSNFGNEKLTF	HIKEYLNKIQNSLST	1
CAFSNFGNEKLTF	YLNKIQNSLSTEWSP	1
CASTNFGNEKLTF	PSDKHIKEYLNKIQN	1
CASTNFGNEKLTF	HIKEYLNKIQNSLST	1
CASTNFGNEKLTF	YLNKIQNSLSTEWSP	1
CARTNFGNEKLTF	PSDKHIKEYLNKIQN	1
CARTNFGNEKLTF	HIKEYLNKIQNSLST	1
CARTNFGNEKLTF	YLNKIQNSLSTEWSP	1
CAFTNFGNEKLTF	PSDKHIKEYLNKIQN	1
CAFTNFGNEKLTF	HIKEYLNKIQNSLST	1
CAFTNFGNEKLTF	YLNKIQNSLSTEWSP	1
CAWGNFGNEKLTF	PSDKHIKEYLNKIQN	1
CAWGNFGNEKLTF	HIKEYLNKIQNSLST	1
CAWGNFGNEKLTF	YLNKIQNSLSTEWSP	1
CAWGNFGNEKLTF	PSDKHIEQYLKKIQNSLSTEWSP	1
CAFSNFGNEKLTF	PSDKHIKEYLNKIQN	1
CAFSNFGNEKLTF	HIKEYLNKIQNSLST	1
CAFSNFGNEKLTF	YLNKIQNSLSTEWSP	1
CAFNNFGNEKLTF	PSDKHIKEYLNKIQN	1
CAFNNFGNEKLTF	HIKEYLNKIQNSLST	1
CAFNNFGNEKLTF	YLNKIQNSLSTEWSP	1
CAFTNFGNEKLTF	PSDKHIKEYLNKIQN	1
CAFTNFGNEKLTF	HIKEYLNKIQNSLST	1
CAFTNFGNEKLTF	YLNKIQNSLSTEWSP	1
CAVYGRDDKIIF	PSDKHIKEYLNKIQN	1
CAVYGRDDKIIF	HIKEYLNKIQNSLST	1
CAVYGRDDKIIF	YLNKIQNSLSTEWSP	1
CAVYGRDDKIIF	PSDKHIEQYLKKIQNSLSTEWSP	1
CAASVPRNTGNQFYF	PSDKHIKEYLNKIQN	1
CAASVPRNTGNQFYF	HIKEYLNKIQNSLST	1
CAASVPRNTGNQFYF	YLNKIQNSLSTEWSP	1
CAENRKGNNNDMRF	PSDKHIKEYLNKIQN	1
CAENRKGNNNDMRF	HIKEYLNKIQNSLST	1
CAENRKGNNNDMRF	YLNKIQNSLSTEWSP	1
CAENMGGYGGATNKLIF	PSDKHIKEYLNKIQN	1
CAENMGGYGGATNKLIF	HIKEYLNKIQNSLST	1
CAENMGGYGGATNKLIF	YLNKIQNSLSTEWSP	1
CAARSNEKLTF	PSDKHIKEYLNKIQN	1
CAARSNEKLTF	HIKEYLNKIQNSLST	1
CAARSNEKLTF	YLNKIQNSLSTEWSP	1
CAARSNEKLTF	PSDKHIEQYLKKIQNSLSTEWSP	1
CAVSSGGNNARLMF	PSDKHIKEYLNKIQN	1
CAVSSGGNNARLMF	HIKEYLNKIQNSLST	1
CAVSSGGNNARLMF	YLNKIQNSLSTEWSP	1
CAASARDMRF	PSDKHIKEYLNKIQN	1
CAASARDMRF	PSDKHIKEYLNKIQN	1
CAASARDMRF	HIKEYLNKIQNSLST	1
CAASARDMRF	HIKEYLNKIQNSLST	1
CAASARDMRF	YLNKIQNSLSTEWSP	1
CAASARDMRF	YLNKIQNSLSTEWSP	1
CAARTNFGNEKLTF	PSDKHIKEYLNKIQN	1
CAARTNFGNEKLTF	PSDKHIKEYLNKIQN	1
CAARTNFGNEKLTF	HIKEYLNKIQNSLST	1
CAARTNFGNEKLTF	HIKEYLNKIQNSLST	1
CAARTNFGNEKLTF	YLNKIQNSLSTEWSP	1
CAARTNFGNEKLTF	YLNKIQNSLSTEWSP	1
CAARSNFGNEKLTF	PSDKHIKEYLNKIQN	1
CAARSNFGNEKLTF	PSDKHIKEYLNKIQN	1
CAARSNFGNEKLTF	HIKEYLNKIQNSLST	1
CAARSNFGNEKLTF	HIKEYLNKIQNSLST	1
CAARSNFGNEKLTF	YLNKIQNSLSTEWSP	1
CAARSNFGNEKLTF	YLNKIQNSLSTEWSP	1
CAENRRAGSYQLTF	PSDKHIKEYLNKIQN	1
CAENRRAGSYQLTF	PSDKHIKEYLNKIQN	1
CAENRRAGSYQLTF	HIKEYLNKIQNSLST	1
CAENRRAGSYQLTF	HIKEYLNKIQNSLST	1
CAENRRAGSYQLTF	YLNKIQNSLSTEWSP	1
CAENRRAGSYQLTF	YLNKIQNSLSTEWSP	1
CAENRRGGSYIPTF	PSDKHIKEYLNKIQN	1
CAENRRGGSYIPTF	PSDKHIKEYLNKIQN	1
CAENRRGGSYIPTF	HIKEYLNKIQNSLST	1
CAENRRGGSYIPTF	HIKEYLNKIQNSLST	1
CAENRRGGSYIPTF	YLNKIQNSLSTEWSP	1
CAENRRGGSYIPTF	YLNKIQNSLSTEWSP	1
CAGNRDSGGGADGLTF	PSDKHIKEYLNKIQN	1
CAGNRDSGGGADGLTF	PSDKHIKEYLNKIQN	1
CAGNRDSGGGADGLTF	HIKEYLNKIQNSLST	1
CAGNRDSGGGADGLTF	HIKEYLNKIQNSLST	1
CAGNRDSGGGADGLTF	YLNKIQNSLSTEWSP	1
CAGNRDSGGGADGLTF	YLNKIQNSLSTEWSP	1
CAAGPNFGNEKLTF	PSDKHIKEYLNKIQN	1
CAAGPNFGNEKLTF	PSDKHIKEYLNKIQN	1
CAAGPNFGNEKLTF	HIKEYLNKIQNSLST	1
CAAGPNFGNEKLTF	HIKEYLNKIQNSLST	1
CAAGPNFGNEKLTF	YLNKIQNSLSTEWSP	1
CAAGPNFGNEKLTF	YLNKIQNSLSTEWSP	1
CVVNPMNRDDKIIF	PSDKHIKEYLNKIQN	1
CVVNPMNRDDKIIF	PSDKHIKEYLNKIQN	1
CVVNPMNRDDKIIF	HIKEYLNKIQNSLST	1
CVVNPMNRDDKIIF	HIKEYLNKIQNSLST	1
CVVNPMNRDDKIIF	YLNKIQNSLSTEWSP	1
CVVNPMNRDDKIIF	YLNKIQNSLSTEWSP	1
CAVLLGGSARQLTF	PSDKHIKEYLNKIQN	1
CAVLLGGSARQLTF	PSDKHIKEYLNKIQN	1
CAVLLGGSARQLTF	HIKEYLNKIQNSLST	1
CAVLLGGSARQLTF	HIKEYLNKIQNSLST	1
CAVLLGGSARQLTF	YLNKIQNSLSTEWSP	1
CAVLLGGSARQLTF	YLNKIQNSLSTEWSP	1
CAVKGTGRRALTF	PSDKHIKEYLNKIQN	1
CAVKGTGRRALTF	PSDKHIKEYLNKIQN	1
CAVKGTGRRALTF	HIKEYLNKIQNSLST	1
CAVKGTGRRALTF	HIKEYLNKIQNSLST	1
CAVKGTGRRALTF	YLNKIQNSLSTEWSP	1
CAVKGTGRRALTF	YLNKIQNSLSTEWSP	1
CAASARDMRF	PSDKHIKEYLNKIQN	1
CAASARDMRF	PSDKHIKEYLNKIQN	1
CAASARDMRF	HIKEYLNKIQNSLST	1
CAASARDMRF	HIKEYLNKIQNSLST	1
CAASARDMRF	YLNKIQNSLSTEWSP	1
CAASARDMRF	YLNKIQNSLSTEWSP	1
CALKKYGNKLVF	PSDKHIKEYLNKIQN	1
CALKKYGNKLVF	PSDKHIKEYLNKIQN	1
CALKKYGNKLVF	HIKEYLNKIQNSLST	1
CALKKYGNKLVF	HIKEYLNKIQNSLST	1
CALKKYGNKLVF	YLNKIQNSLSTEWSP	1
CALKKYGNKLVF	YLNKIQNSLSTEWSP	1
CAGPGDSNYQLIW	PSDKHIKEYLNKIQN	1
CAGPGDSNYQLIW	PSDKHIKEYLNKIQN	1
CAGPGDSNYQLIW	HIKEYLNKIQNSLST	1
CAGPGDSNYQLIW	HIKEYLNKIQNSLST	1
CAGPGDSNYQLIW	YLNKIQNSLSTEWSP	1
CAGPGDSNYQLIW	YLNKIQNSLSTEWSP	1
CAARTNFGNEKLTF	PSDKHIKEYLNKIQN	1
CAARTNFGNEKLTF	PSDKHIKEYLNKIQN	1
CAARTNFGNEKLTF	HIKEYLNKIQNSLST	1
CAARTNFGNEKLTF	HIKEYLNKIQNSLST	1
CAARTNFGNEKLTF	YLNKIQNSLSTEWSP	1
CAARTNFGNEKLTF	YLNKIQNSLSTEWSP	1
CAAIVQGNLIF	PSDKHIKEYLNKIQN	1
CAAIVQGNLIF	PSDKHIKEYLNKIQN	1
CAAIVQGNLIF	HIKEYLNKIQNSLST	1
CAAIVQGNLIF	HIKEYLNKIQNSLST	1
CAAIVQGNLIF	YLNKIQNSLSTEWSP	1
CAAIVQGNLIF	YLNKIQNSLSTEWSP	1
CAAHTDSGGGADGLTF	PSDKHIKEYLNKIQN	1
CAAHTDSGGGADGLTF	PSDKHIKEYLNKIQN	1
CAAHTDSGGGADGLTF	HIKEYLNKIQNSLST	1
CAAHTDSGGGADGLTF	HIKEYLNKIQNSLST	1
CAAHTDSGGGADGLTF	YLNKIQNSLSTEWSP	1
CAAHTDSGGGADGLTF	YLNKIQNSLSTEWSP	1
CAVILSGSARQLTF	PSDKHIKEYLNKIQN	1
CAVILSGSARQLTF	PSDKHIKEYLNKIQN	1
CAVILSGSARQLTF	HIKEYLNKIQNSLST	1
CAVILSGSARQLTF	HIKEYLNKIQNSLST	1
CAVILSGSARQLTF	YLNKIQNSLSTEWSP	1
CAVILSGSARQLTF	YLNKIQNSLSTEWSP	1
CAAYSFGGNEKLTF	PSDKHIKEYLNKIQN	1
CAAYSFGGNEKLTF	PSDKHIKEYLNKIQN	1
CAAYSFGGNEKLTF	HIKEYLNKIQNSLST	1
CAAYSFGGNEKLTF	HIKEYLNKIQNSLST	1
CAAYSFGGNEKLTF	YLNKIQNSLSTEWSP	1
CAAYSFGGNEKLTF	YLNKIQNSLSTEWSP	1
CAGLFGNEKLTF	PSDKHIKEYLNKIQN	1
CAGLFGNEKLTF	HIKEYLNKIQNSLST	1
CAGLFGNEKLTF	YLNKIQNSLSTEWSP	1
CAENAGNQFYF	PSDKHIKEYLNKIQN	1
CAENAGNQFYF	HIKEYLNKIQNSLST	1
CAENAGNQFYF	YLNKIQNSLSTEWSP	1
CALRGARLMF	PSDKHIKEYLNKIQN	1
CALRGARLMF	HIKEYLNKIQNSLST	1
CALRGARLMF	YLNKIQNSLSTEWSP	1
CALRVGGSRLTF	PSDKHIKEYLNKIQN	1
CALRVGGSRLTF	HIKEYLNKIQNSLST	1
CALRVGGSRLTF	YLNKIQNSLSTEWSP	1
CAVFNFGNEKLTF	PSDKHIKEYLNKIQN	1
CAVFNFGNEKLTF	HIKEYLNKIQNSLST	1
CAVFNFGNEKLTF	YLNKIQNSLSTEWSP	1
CAVFNFGNEKLTF	PSDKHIEQYLKKIQNSLSTEWSP	1
CAGGNNFGNEKLTF	PNANPNVDPNANPNV	1
CAGGNNFGNEKLTF	PNANPNVDPNANPNV	1
CAILSGTYKYIF	PNANPNVDPNANPNV	1
CAILSGTYKYIF	PNANPNVDPNANPNV	1
CAMRRFQGAQKLVF	PNANPNVDPNANPNV	1
CAMRRFQGAQKLVF	PNANPNVDPNANPNV	1
CATESSGANSKLTF	PNANPNVDPNANPNV	1
CATESSGANSKLTF	PNANPNVDPNANPNV	1
CAALQGAQKLVF	PNANPNVDPNANPNV	1
CAALQGAQKLVF	PNANPNVDPNANPNV	1
CILRDGGATNKLIF	PNANPNVDPNANPNV	1
CILRDGGATNKLIF	PNANPNVDPNANPNV	1
CALDMVAGAGNMLTF	PNANPNVDPNANPNV	1
CALDMVAGAGNMLTF	PNANPNVDPNANPNV	1
CVVSHLSGTYKYIF	PNANPNVDPNANPNV	1
CVVSHLSGTYKYIF	PNANPNVDPNANPNV	1
CAASARGNQKLVF	PNANPNVDPNANPNV	1
CAASARGNQKLVF	PNANPNVDPNANPNV	1
CAASPPGAQKLVF	PNANPNVDPNANPNV	1
CAASPPGAQKLVF	PNANPNVDPNANPNV	1
CIVKNGGTSYGKLTF	RNVDENANANSAVKN	1
CIVKNGGTSYGKLTF	RNVDENANANSAVKN	1
CIVKNGGTSYGKLTF	RNVDENANANSAVKN	1
CIVKNGGTSYGKLTF	RNVDENANANSAVKN	1
CAVGPRGTGFQKLVF	RNVDENANANSAVKN	1
CAVGPRGTGFQKLVF	RNVDENANANSAVKN	1
CAASLPQGGSEKLVF	ATGFKQSSKALQRPVAS	1
CALSDPRGGSQGNLIF	PGVLLKEFTVSGNIL	1
CAFMQGKSTF	PGVLLKEFTVSGNIL	1
CAVIIQGAQKLVF	PGVLLKEFTVSGNIL	1
CAGTQGGSEKLVF	PGVLLKEFTVSGNIL	1
CAFISTQGGSEKLVF	PGVLLKEFTVSGNIL	1
CAMRQGGSEKLVF	PGVLLKEFTVSGNIL	1
CALRDSGGGADGLTF	PGVLLKEFTVSGNIL	1
CAVPNSGNTPLVF	PGVLLKEFTVSGNIL	1
CAVPNSGNTPLVF	PGVLLKEFTVSGNIL	1
CAEAENQAGTALIF	PGVLLKEFTVSGNIL	1
CAAAAGNTGKLIF	SLFFSAQPFEITAST	1
CAVRSYSGGGADGLTF	SLFFSAQPFEITAST	1
CAVRYGGSQGNLIF	SLFFSAQPFEITAST	1
EYGNKLVF	SLFFSAQPFEITAST	1
CAVGAWEYGNKLVF	SLFFSAQPFEITAST	1
CAASFDSSYKLIF	SLFFSAQPFEITAST	1
CAVSDRTGANSKLTF	SLFFSAQPFEITAST	1
CAVSENTGFQKLVF	SLFFSAQPFEITAST	1
CAVSGGGATNKLIF	SLFFSAQPFEITAST	1
CAVSGRFSGNTGKLIF	SLFFSAQPFEITAST	1
CAVSPNQAGTALIF	SLFFSAQPFEITAST	1
CAVSPTGGGNKLTF	SLFFSAQPFEITAST	1
CAYRSERASGTYKYIF	SLFFSAQPFEITAST	1
CAYSGTYKYIF	SLFFSAQPFEITAST	1
CDDSGAGSYQLTF	SLFFSAQPFEITAST	1
CAASSRGKLIF	SLFFSAQPFEITAST	1
TTDSWGKFEF	SLFFSAQPFEITAST	1
CILGGGTSYGKLTF	SLFFSAQPFEITAST	1
CILLGAGNNRKLIW	SLFFSAQPFEITAST	1
CIVRPPSGTYKYIF	SLFFSAQPFEITAST	1
CAASKGSGYSTLTF	SLFFSAQPFEITAST	1
CSPTGTASKLTF	SLFFSAQPFEITAST	1
CVVNKEVGLDDKIIF	SLFFSAQPFEITAST	1
CVVNIPTGGFKTIF	SLFFSAQPFEITAST	1
CAASKRSGGSYIPTF	SLFFSAQPFEITAST	1
CVVNMRSNAGNMLTF	SLFFSAQPFEITAST	1
CVVNPGGYNKLIF	SLFFSAQPFEITAST	1
CVVNRQGGSQGNLIF	SLFFSAQPFEITAST	1
CVVNSREAGRRALTF	SLFFSAQPFEITAST	1
CVVPNNAGNMLTF	SLFFSAQPFEITAST	1
CVVRDNTNAGKSTF	SLFFSAQPFEITAST	1
CAASRGGSQGNLIF	SLFFSAQPFEITAST	1
CAASRSGGSNYKLTF	SLFFSAQPFEITAST	1
CAASRWGGFGNVLHC	SLFFSAQPFEITAST	1
CALSEAYGQKLLF	SLFFSAQPFEITAST	1
CAASWAGGTSYGKLTF	SLFFSAQPFEITAST	1
CAAYKAAGNKLTF	SLFFSAQPFEITAST	1
CAEIVTSGTYKYIF	SLFFSAQPFEITAST	1
CAELRTSGGYNKLIF	SLFFSAQPFEITAST	1
FSGGYNKLIF	SLFFSAQPFEITAST	1
CAESLLFSDGQKLLF	SLFFSAQPFEITAST	1
CALSDRADDYKLSF	SLFFSAQPFEITAST	1
CAFGRSGASKLTF	SLFFSAQPFEITAST	1
CAFGRSGASKLTF	SLFFSAQPFEITAST	1
CAFMKGTASKLTF	SLFFSAQPFEITAST	1
CAFMLIFGNEKLTF	SLFFSAQPFEITAST	1
CAGHDTSGTYKYIF	SLFFSAQPFEITAST	1
CAALFSGGYNKLIF	SLFFSAQPFEITAST	1
NAGGTSYGKLTF	SLFFSAQPFEITAST	1
CAVKLLNAGGTSYGKLTF	SLFFSAQPFEITAST	1
NAGGTSYGKLTF	SLFFSAQPFEITAST	1
CAVKLLNAGGTSYGKLTF	SLFFSAQPFEITAST	1
NAGGTSYGKLTF	SLFFSAQPFEITAST	1
CAVKLLNAGGTSYGKLTF	SLFFSAQPFEITAST	1
CAGPGSGGYQKVTF	SLFFSAQPFEITAST	1
CAGQLRAGANSKLTF	SLFFSAQPFEITAST	1
CAGRIFGNEKLTF	SLFFSAQPFEITAST	1
CAGSSTSGTYKYIF	SLFFSAQPFEITAST	1
CAGVNTGNQFYF	SLFFSAQPFEITAST	1
CALGMQGGSEKLVF	SLFFSAQPFEITAST	1
CALISGGYQKVTF	SLFFSAQPFEITAST	1
CALPFSGGYNKLIF	SLFFSAQPFEITAST	1
FSGGYNKLIF	SLFFSAQPFEITAST	1
CALSAGGYQKVTF	SLFFSAQPFEITAST	1
CALSDSTNAGKSTF	SLFFSAQPFEITAST	1
CAAQPYSNSGYALNF	SLFFSAQPFEITAST	1
CAARGETSGSRLTF	SLFFSAQPFEITAST	1
CAMSAPAGNMLTF	SLFFSAQPFEITAST	1
CAGGGGGYSTLTF	SLFFSAQPFEITAST	1
CAPTRTPLVF	SLFFSAQPFEITAST	1
CAQRENAGNMLTF	SLFFSAQPFEITAST	1
CASPRRTGANNLFF	SLFFSAQPFEITAST	1
CAARLNYGGSQGNLIF	SLFFSAQPFEITAST	1
CATDVRDGNYQLIW	SLFFSAQPFEITAST	1
CATRGEGSYQLTF	SLFFSAQPFEITAST	1
CATRGNSGNTPLVF	SLFFSAQPFEITAST	1
SYNTDKLIF	SLFFSAQPFEITAST	1
CVVRGSYNTDKLIF	SLFFSAQPFEITAST	1
CAVAPLTGGGNKLTF	SLFFSAQPFEITAST	1
CAVDFGNEKLTF	SLFFSAQPFEITAST	1
CAVDIGWRDDKIIF	SLFFSAQPFEITAST	1
CAVEKAGANNLFF	SLFFSAQPFEITAST	1
CAVGALAAGNKLTF	SLFFSAQPFEITAST	1
CAVGAQGGGYQKVTF	SLFFSAQPFEITAST	1
CAVGASNDMRF	SLFFSAQPFEITAST	1
CAVGATGANNLFF	SLFFSAQPFEITAST	1
CAVGSGGYQKVTF	SLFFSAQPFEITAST	1
CAVHRSAAAGNKLTF	SLFFSAQPFEITAST	1
CAASANTGNQFYF	SLFFSAQPFEITAST	1
CAVLDSNYQLIW	SLFFSAQPFEITAST	1
CAVLSGSYQLTF	SLFFSAQPFEITAST	1
CAASARGSNYKLTF	SLFFSAQPFEITAST	1
CALSEGNAGGTSYGKLTF	SLFFSAQPFEITAST	1
CAVNSGGSNYKLTF	SLFFSAQPFEITAST	1
NSGGSNYKLTF	SLFFSAQPFEITAST	1
CAVPFAGGYNKLIF	SLFFSAQPFEITAST	1
CAVRAARYNNNDMRF	SLFFSAQPFEITAST	1
CAVRDATGGSYIPTF	SLFFSAQPFEITAST	1
CAVRDYGTDKLIF	SLFFSAQPFEITAST	1
CAASDTDKLIF	SLFFSAQPFEITAST	1
CAVRGPTGANNLFF	SLFFSAQPFEITAST	1
CAASEDQAGTALIF	SLFFSAQPFEITAST	1
NTGFQKLVF	SLFFSAQPFEITAST	1
CAAIGFQKLVF	SLFFSAQPFEITAST	1
CAVRRGGSNYKLTF	SLFFSAQPFEITAST	1
YNFNKFYF	SPNNFLSYYRLTRFLSRVIK	1
CAVAPYDRGSTLGRLYF	VFVQSVLPYFVATKLAKIRK	1
CAGVKDSNYQLIW	VFVQSVLPYFVATKLAKIRK	1
CALSDLSYGGATNKLIF	YNYIASFFIETGFCDSGILS	1
CAVEVNSGTYKYIF	AISRKMVELVHFLLLKYRAR	1
CALSVGTYKYIF	AISRKMVELVHFLLLKYRAR	1
CAFMKRAETSGSRLTF	SGWGDPHYITFDGTYYTFLD	1
CVVSGGVNGGATNKLIF	SLLMWITQCFLPVF	1
CAASVRGSTLGRLYF	DFHFEVFNFVPCSI	1
CAVSGGRGSTLGRLYF	DFHFEVFNFVPCSI	1
CAASVRGSTLGRLYF	DFHFEVFNFVPCSI	1
CAYRSNNFNKFYF	DFHFEVFNFVPCSI	1
CAASVRGSTLGRLYF	DFHFEVFNFVPCSI	1
CAVEERTGGFKTIF	DFHFEVFNFVPCSI	1
CAVSGGRGSTLGRLYF	DFHFEVFNFVPCSI	1
CLVGDLGANAGNMLTF	FNNFTVSFWLRVPKVSASHLE	1
CLVGDLGANAGNMLTF	FNNFTVSFWLRVPKVSASHLE	1
CAVALYGGATNKLIF	FNNFTVSFWLRVPKVSASHLE	1
CAGRSGGSNYKLTF	FNNFTVSFWLRVPKVSASHLE	1
CALLQGAQKLVF	MTEYKLVVVGAVGVGKSALTIQLI	1
CATDGETSGSRLTF	MTEYKLVVVGAVGVGKSALTIQLI	1
CAMRANTDKLIF	MTEYKLVVVGAGDVGKSALTIQLI	1
CAMRANTDKLIF	MTEYKLVVVGAGDVGKSALTIQLI	1
CAASTGGGNKLTF	MTEYKLVVVGAVGVGKSALTIQLI	1
CAVEGAGSYQLTF	MTEYKLVVVGARGVGKSALTIQLI	1
CAASGNTGTASKLTF	MTEYKLVVVGARGVGKSALTIQLI	1
CAVGGRASGSARQLTF	LLEFYLAMPFATP	1
CAASNRFSGGYNKLIF	LLEFYLAMPFATP	1
CAERAGTASKLTF	LLEFYLAMPFATP	1
CWSPNQAGTALIF	LLEFYLAMPFATP	1
CAVKKSSGSARQLTF	LLEFYLAMPFATP	1
CAAISNAGGTSYGKLTF	LLEFYLAMPFATP	1
CAAIRSSGSRLTF	LLEFYLAMPFATP	1
CAPVSNAGKSTF	LLEFYLAMPFATP	1
CAASRNFGNEKLTF	LLEFYLAMPFATP	1
CAGPYTGANSKLTF	LLEFYLAMPFATP	1
CAASSPSGGYQKVTF	LLEFYLAMPFATP	1
CASISNTGNQFYF	LLEFYLAMPFATP	1
CAEYSGAGSYQLTF	LLEFYLAMPFATP	1
CALSEAGANSKLTF	QLQPFPQPELPY	1
CAGQLDSGTYKYI	QLQPFPQPELPY	1
CLVGGDNQGGKLIF	PQPELPYPQPQL	1
CAVNARNAGNMLTF	QLQPFPQPELPY	1
CIANYGQNFVF	FPQPEQPFPWQP	1
CAVEGGSNYKLTF	QLQPFPQPELPY	1
CIVYNNNDMRF	PQPELPYPQPQL	1
CIVFNDYKLSF	PQPELPYPQPQL	1
CIALNARLMF	PQPELPYPQPQL	1
CAMREGRYSSASKIIF	FPQPEQPFPWQP	1
CLVGDGDGGATNKLIF	FPQPEQPFPWQP	1
CIVYNDYKLSF	PQPELPYPQPQL	1
CAASVLYGSSNTGKLIF	QLQPFPQPELPY	1
CAEAGGGNKLTF	QLQPFPQPELPY	1
CAGQPGSSNTGKLIF	QLQPFPQPELPY	1
CAMIEAAGNKLTF	QLQPFPQPELPY	1
CAMIEAAGNKLTF	QLQPFPQPELPY	1
CAMKDYGQNFVF	QLQPFPQPELPY	1
CAMLEAAGNKLTF	QLQPFPQPELPY	1
CAMTDYGNNRLAF	QLQPFPQPELPY	1
CAVEGGSNYKLTF	QLQPFPQPELPY	1
CAVGAAEYGNKLVF	QLQPFPQPELPY	1
CAVGASEYGNKLVF	QLQPFPQPELPY	1
CAVGAVEYGNKLVF	QLQPFPQPELPY	1
CAVGTDRGSTLGRLYF	QLQPFPQPELPY	1
CAVNARNAGNMLTF	QLQPFPQPELPY	1
CLVGGAGGYNKLIF	QLQPFPQPELPY	1
CLVGGSGGYNKLIF	QLQPFPQPELPY	1
CLVGGSGGYNKLIF	QLQPFPQPELPY	1
CIAFNDYKLSF	PQPELPYPQPQL	1
CIAFNDYKLSF	PQPELPYPQPQL	1
CIAYNDYKLSF	PQPELPYPQPQL	1
CIAYNDYKLSF	PQPELPYPQPQL	1
CIPNYGGSQGNLIF	PQPELPYPQPQL	1
CIVFGGSQGNLIF	PQPELPYPQPQL	1
CIVFNDYKLSF	PQPELPYPQPQL	1
CIVFNDYKLSF	PQPELPYPQPQL	1
CIVLGGATNKLIF	PQPELPYPQPQL	1
CIVLNARLMF	PQPELPYPQPQL	1
CIVLNARLMF	PQPELPYPQPQL	1
CIVPPGTASKLTF	PQPELPYPQPQL	1
CIVTGNQFYF	PQPELPYPQPQL	1
CIVWNNDMRF	PQPELPYPQPQL	1
CIVYGGSQGNLIF	PQPELPYPQPQL	1
CIVYGGSQGNLIF	PQPELPYPQPQL	1
CIVYNDYKLSF	PQPELPYPQPQL	1
CIVYNDYKLSF	PQPELPYPQPQL	1
CIVYNNDMRF	PQPELPYPQPQL	1
CMDEGGSNYKLTF	PQPELPYPQPQL	1
CSLYNNNDMRF	PQPELPYPQPQL	1
TTDSWGKFEF	PQQPFPQPEQPFP	1
CAPQGATNKLIF	PQQPFPQPEQPFP	1
CLVGGSGGYNKLIF	PQQPFPQPEQPFP	1
CAVQAGGNNRLAF	GQVELGGGNAVEVCK	1
CAFFGQGAQKLVF	GQVELGGGNAVEVCK	1
CIVRDSNYQLIW	GQVELGGGNAVEVCK	1
CAVGGTSGSARQLTF	GQVELGGGNAVEVCK	1
CAVGFNAGKSTF	GQVELGGGNAVEVCK	1
CAMRPNNAGNMLTF	GQVELGGGNAVEVCK	1
CIVRVNNAGNMLTF	GQVELGGGNAVEVCK	1
CAVNQAGTALIF	GQVELGGGNAVEVCK	1
CAVRDGGSYIPTF	GQVELGGGNAVEVCK	1
CALSEVNTGGFKTIF	GQVELGGGNAVEVCK	1
CIVRVEIQGAQKLVF	GQVELGGGNAVEVCK	1
CIVRVGYNAGNMLTF	GQVELGGGNAVEVCK	1
CIVRPQKGGSQGNLIF	GQVELGGGNAVEVCK	1
CIVRVAIEGSQGNLIF	GQVELGGGNAVEVCK	1
CIVRLQSGGFKTIF	GQVELGGGNAVEVCK	1
CAVDIQGAQKLVF	GQVELGGGNAVEVCK	1
CGTLAFGNEKLTF	GQVELGGGNAVEVCK	1
CAVNHGNEKLTF	GQVELGGGNAVEVCK	1
